,nombre_circuito,numero_mesa,votos_fpv,votos_cambiemos,votos_blancos,votos_nulos,votos_recurridos,total
0,158B,5513,80,134,0,3,0,217
1,158B,5514,54,155,1,5,0,215
2,158B,5515,75,140,4,3,0,222
3,158B,5516,54,154,2,8,0,218
4,147B,5089,72,156,2,3,0,233
5,147B,5090,51,180,5,2,0,238
6,147B,5091,60,176,3,9,0,248
7,147B,5092,61,170,5,4,0,240
8,147B,5093,53,177,2,4,0,236
9,147B,5094,52,191,0,1,1,245
10,151,5183,139,97,10,0,0,246
11,151,5184,151,103,1,8,0,263
12,156E,5468,46,155,0,1,0,202
13,156B,5449,71,98,4,0,0,173
14,156B,5450,81,90,5,2,0,178
15,155A,5282,86,178,3,1,0,268
16,155A,5283,94,157,3,8,0,262
17,155A,5284,78,176,3,10,0,267
18,156,5285,67,193,2,4,0,266
19,156,5286,64,184,4,5,0,257
20,156,5287,63,204,0,7,0,274
21,156,5288,62,199,6,5,0,272
22,156,5289,50,221,2,1,11,285
23,156,5290,71,200,1,4,0,276
24,156,5291,72,210,3,5,0,290
25,156,5292,68,188,2,3,0,261
26,156,5293,68,210,3,5,0,286
27,156,5294,52,219,2,6,0,279
28,156,5295,75,199,3,4,0,281
29,156,5296,35,235,3,7,0,280
30,156,5297,62,206,3,6,0,277
31,156,5298,48,225,1,5,0,279
32,156,5299,65,194,1,2,0,262
33,156,5300,84,189,4,5,0,282
34,156,5301,84,183,1,10,0,278
35,156,5302,59,223,2,3,0,287
36,156,5303,47,213,0,5,0,265
37,156,5304,52,235,3,2,0,292
38,156,5305,47,210,2,10,0,269
39,156,5306,46,226,3,1,0,276
40,156,5307,61,221,4,1,0,287
41,156,5308,59,213,1,5,0,278
42,156,5309,49,220,3,6,0,278
43,156,5310,67,201,2,1,0,271
44,156,5311,70,184,0,5,0,259
45,156,5312,57,271,0,1,0,329
46,156,5313,54,216,1,3,0,274
47,156,5314,61,212,2,9,0,284
48,156,5315,59,207,0,4,0,270
49,156,5316,75,192,1,2,0,270
50,156,5317,53,213,4,2,0,272
51,156,5318,67,209,1,1,0,278
52,156,5319,50,203,6,6,0,265
53,156,5320,55,195,3,3,0,256
54,156,5321,57,217,2,3,0,279
55,156,5322,60,202,5,2,0,269
56,156,5323,59,209,3,7,0,278
57,156,5324,63,212,2,4,0,281
58,156,5325,50,221,1,2,0,274
59,156,5326,91,186,3,3,0,283
60,156,5327,213,48,11,0,0,272
61,156,5328,51,214,3,5,0,273
62,156,5329,55,212,1,3,0,271
63,156,5330,55,210,3,2,0,270
64,156,5331,72,197,3,7,0,279
65,156,5332,70,180,0,5,0,255
66,156,5333,74,192,2,6,1,275
67,156,5334,73,209,0,4,0,286
68,156,5335,59,213,0,1,0,273
69,156,5336,77,198,4,6,0,285
70,156,5337,63,210,2,5,0,280
71,156,5338,49,213,5,7,0,274
72,156,5339,41,227,0,4,0,272
73,156,5340,66,200,4,5,0,275
74,156,5341,38,222,2,1,0,263
75,156,5342,60,209,3,2,0,274
76,156,5343,59,215,0,2,0,276
77,156,5344,59,219,2,0,0,280
78,156,5345,46,201,2,6,0,255
79,156,5346,69,189,0,9,0,267
80,156,5347,42,229,3,7,0,281
81,156,5348,51,225,1,2,0,279
82,156,5349,57,208,4,3,0,272
83,156,5350,53,202,2,11,0,268
84,156,5351,74,199,5,0,0,278
85,156,5352,75,203,1,3,0,282
86,156,5353,79,185,1,5,0,270
87,156,5354,50,199,4,5,0,258
88,156,5355,60,201,5,3,0,269
89,156,5356,67,197,4,0,4,272
90,156,5357,57,215,1,0,0,273
91,156,5358,40,227,0,3,0,270
92,156,5359,36,211,3,5,0,255
93,156,5360,68,199,3,2,0,272
94,156,5361,42,215,4,5,0,266
95,156,5362,57,201,2,6,0,266
96,156,5363,55,208,3,3,0,269
97,156,5364,65,202,7,3,0,277
98,156,5365,70,203,0,4,0,277
99,156,5366,70,197,2,0,0,269
100,156,5367,56,192,3,6,0,257
101,156,5368,50,218,1,7,0,276
102,156,5369,67,185,0,8,0,260
103,156,5370,71,205,2,4,0,282
104,156,5371,53,221,3,3,0,280
105,156,5372,65,202,1,6,0,274
106,156,5373,69,192,0,2,0,263
107,156,5374,46,224,1,3,0,274
108,156,5375,50,215,1,5,0,271
109,156,5376,52,220,1,2,0,275
110,156,5377,46,228,5,1,0,280
111,156,5378,75,191,3,6,1,276
112,156,5379,66,191,2,7,0,266
113,156,5380,44,221,2,4,0,271
114,156,5381,62,186,12,6,0,266
115,156,5382,60,195,6,13,0,274
116,156,5383,67,193,3,2,0,265
117,156,5384,63,193,1,8,0,265
118,156,5385,58,196,2,4,0,260
119,156,5386,67,215,3,9,0,294
120,156,5387,56,224,2,6,0,288
121,156,5388,61,202,2,7,0,272
122,156,5389,67,193,3,3,0,266
123,156,5390,61,200,2,10,0,273
124,156,5391,80,190,4,3,0,277
125,156,5392,63,186,4,6,0,259
126,156,5393,70,194,4,1,0,269
127,156,5394,58,228,1,3,0,290
128,156,5395,42,222,0,4,0,268
129,156,5396,48,211,2,3,0,264
130,156,5397,54,209,1,4,0,268
131,156,5398,74,178,3,4,0,259
132,156,5399,81,169,0,2,0,252
133,156,5400,72,193,2,2,0,269
134,156,5401,60,214,2,5,0,281
135,156,5402,42,220,1,5,0,268
136,156,5403,74,192,0,1,0,267
137,156,5404,61,204,2,5,0,272
138,156,5405,38,231,2,7,0,278
139,156,5406,77,187,1,6,0,271
140,156,5407,64,189,1,5,0,259
141,156,5408,74,203,1,1,0,279
142,156,5409,56,214,1,3,0,274
143,156,5410,58,216,0,3,0,277
144,156,5411,64,201,0,11,0,276
145,156,5412,70,211,3,3,0,287
146,156,5413,64,199,2,7,0,272
147,156,5414,62,209,3,4,0,278
148,156,5415,71,193,4,2,1,271
149,156,5416,82,167,1,6,0,256
150,156,5417,39,214,2,3,0,258
151,156,5418,64,200,2,4,0,270
152,156,5419,47,214,2,5,0,268
153,156,5420,56,198,3,10,0,267
154,156,5421,57,194,5,3,0,259
155,156,5422,59,223,4,3,0,289
156,156,5423,50,213,6,0,0,269
157,156,5424,54,208,4,1,0,267
158,156,5425,59,205,3,8,0,275
159,156,5426,51,198,3,8,0,260
160,156,5427,53,216,1,1,0,271
161,156,5428,59,194,1,8,0,262
162,156,5429,55,196,5,2,0,258
163,156,5430,50,217,2,9,0,278
164,156,5431,60,207,1,4,0,272
165,156,5432,88,196,1,1,0,286
166,156,5433,60,219,4,4,0,287
167,156,5434,70,176,4,7,0,257
168,156,5435,50,200,2,1,0,253
169,156,5436,76,178,3,5,0,262
170,156,5437,71,188,4,2,0,265
171,156,5438,78,178,6,6,0,268
172,156,5439,74,200,2,2,0,278
173,156,5440,49,213,1,9,0,272
174,156,5441,60,202,1,2,0,265
175,156,5442,48,208,3,5,1,265
176,156,5443,56,198,2,3,0,259
177,152,5185,75,179,2,10,0,266
178,152,5186,64,174,3,9,0,250
179,152,5187,78,178,2,5,0,263
180,152,5188,83,176,0,3,0,262
181,152,5189,80,172,1,4,0,257
182,152,5190,77,189,4,6,0,276
183,152,5191,68,166,2,9,0,245
184,152,5192,80,186,0,6,0,272
185,152,5193,58,191,1,11,0,261
186,152,5194,63,186,3,5,0,257
187,152,5195,68,188,3,3,0,262
188,152,5196,83,170,1,10,0,264
189,152,5197,71,176,3,11,0,261
190,152,5198,80,161,2,9,0,252
191,152,5199,65,177,3,17,0,262
192,152,5200,77,176,3,10,0,266
193,152,5201,72,167,2,8,0,249
194,156C,5451,74,160,3,5,0,242
195,156C,5452,68,157,3,5,0,233
196,156C,5453,78,154,2,6,0,240
197,156C,5454,81,147,4,5,0,237
198,152A,5202,56,203,3,5,0,267
199,152A,5203,77,172,3,9,0,261
200,152A,5204,55,211,3,3,0,272
201,152A,5205,82,180,2,11,0,275
202,152A,5206,75,183,3,3,0,264
203,152A,5207,88,168,1,1,0,258
204,152A,5208,80,175,3,7,0,265
205,152A,5209,74,184,2,9,0,269
206,152A,5210,62,189,1,8,0,260
207,152A,5211,60,189,4,4,0,257
208,152A,5212,80,172,1,6,0,259
209,152A,5213,52,207,0,3,0,262
210,152A,5214,80,180,2,2,0,264
211,152A,5215,88,161,2,3,0,254
212,152A,5216,83,187,2,1,0,273
213,156A,5444,82,180,1,5,0,268
214,156A,5445,84,166,2,3,0,255
215,156A,5446,71,189,1,2,0,263
216,156A,5447,77,183,2,11,0,273
217,156A,5448,96,174,5,7,0,282
218,150,5127,90,179,1,1,0,271
219,150,5128,85,183,2,0,0,270
220,150,5129,78,203,0,6,0,287
221,150,5130,86,169,5,5,0,265
222,150,5131,81,164,4,6,0,255
223,150,5132,75,183,2,6,0,266
224,150,5133,72,194,2,5,0,273
225,150,5134,61,182,4,8,0,255
226,150,5135,74,176,0,6,0,256
227,150,5136,78,170,2,4,1,255
228,150,5137,75,180,0,5,0,260
229,150,5138,77,164,5,4,0,250
230,150,5139,57,195,3,3,0,258
231,150,5140,65,185,2,5,0,257
232,150,5141,82,181,4,3,0,270
233,150,5142,61,193,1,9,0,264
234,150,5143,75,174,1,3,0,253
235,150,5144,72,180,3,4,0,259
236,150,5145,95,176,1,5,0,277
237,150,5146,90,175,0,6,0,271
238,150,5147,69,180,0,5,0,254
239,150,5148,64,198,2,3,0,267
240,150,5149,73,174,3,4,0,254
241,150,5150,86,163,1,9,0,259
242,150,5151,91,175,1,11,0,278
243,150,5152,97,169,6,7,0,279
244,150,5153,86,178,4,6,0,274
245,150,5154,70,169,3,2,0,244
246,150,5155,85,173,0,5,0,263
247,150,5156,94,154,1,7,0,256
248,150,5157,68,193,5,4,0,270
249,150,5158,70,186,2,4,0,262
250,150,5159,70,185,3,5,0,263
251,150,5160,74,174,5,8,0,261
252,150,5161,85,182,2,1,0,270
253,150,5162,84,166,7,5,2,264
254,150,5163,63,181,4,2,0,250
255,150,5164,85,185,2,6,1,279
256,150,5165,77,180,1,7,0,265
257,150,5166,71,184,0,5,0,260
258,150,5167,80,170,4,5,0,259
259,150,5168,92,153,12,0,0,257
260,150,5169,66,175,3,11,0,255
261,150,5170,68,165,6,8,0,247
262,150,5171,81,167,3,14,0,265
263,150,5172,99,150,3,7,0,259
264,150,5173,86,173,1,1,0,261
265,150,5174,76,181,1,5,0,263
266,150,5175,67,192,11,0,0,270
267,150,5176,76,167,3,14,0,260
268,150,5177,84,156,1,13,0,254
269,150,5178,72,189,1,9,0,271
270,150,5179,72,181,1,2,0,256
271,150,5180,100,164,2,4,0,270
272,150,5181,117,150,3,4,0,274
273,150,5182,90,159,0,7,0,256
274,153,5217,71,191,1,3,0,266
275,153,5218,57,175,1,8,0,241
276,153,5219,76,197,0,2,0,275
277,153,5220,61,194,3,1,0,259
278,153,5221,49,209,3,7,0,268
279,153,5222,64,174,7,3,0,248
280,153,5223,89,152,3,6,0,250
281,153,5224,47,211,1,3,0,262
282,153,5225,49,208,2,4,0,263
283,153,5226,48,211,1,2,0,262
284,153,5227,62,188,0,5,0,255
285,153,5228,63,205,1,7,0,276
286,153,5229,0,0,5,7,0,12
287,153,5230,66,188,2,7,0,263
288,153,5231,52,203,0,5,0,260
289,153,5232,71,196,2,7,0,276
290,153,5233,53,190,0,5,0,248
291,153,5234,61,192,2,3,0,258
292,153,5235,54,204,5,7,0,270
293,153,5236,63,195,2,1,0,261
294,153,5237,62,192,1,6,0,261
295,158,5493,83,187,0,1,0,271
296,158,5494,80,161,7,12,0,260
297,158,5495,60,200,3,4,0,267
298,158,5496,84,172,1,4,0,261
299,158,5497,77,175,3,5,0,260
300,158,5498,83,174,2,6,0,265
301,158,5499,0,0,0,0,0,0
302,158,5500,73,181,4,1,0,259
303,158,5501,82,175,1,5,0,263
304,158,5502,95,164,0,7,0,266
305,158,5503,68,163,7,6,0,244
306,158,5504,80,175,5,6,0,266
307,158,5505,96,160,0,3,0,259
308,158,5506,63,186,4,5,0,258
309,158,5507,85,147,2,9,0,243
310,158,5508,76,167,2,7,0,252
311,158,5509,74,185,2,2,0,263
312,158,5510,69,171,2,3,0,245
313,154,5238,83,177,1,7,0,268
314,154,5239,79,202,5,2,0,288
315,154,5240,72,184,0,8,0,264
316,154,5241,75,176,4,5,0,260
317,154,5242,67,180,3,3,0,253
318,154,5243,57,202,1,3,0,263
319,154,5244,54,211,2,0,0,267
320,154,5245,68,194,1,3,0,266
321,154,5246,62,190,2,7,0,261
322,154,5247,67,198,5,7,0,277
323,154,5248,51,197,10,0,0,258
324,154,5249,65,195,2,3,0,265
325,154,5250,69,197,2,4,0,272
326,154,5251,75,180,2,3,0,260
327,154,5252,74,175,1,7,0,257
328,154,5253,72,176,3,3,0,254
329,154,5254,74,164,1,3,0,242
330,154,5255,59,187,2,2,0,250
331,154,5256,62,186,1,13,0,262
332,154,5257,64,181,1,11,0,257
333,154,5258,50,210,2,3,0,265
334,154,5259,85,175,3,9,0,272
335,154,5260,75,173,3,8,0,259
336,154,5261,67,194,3,5,0,269
337,154,5262,54,201,5,7,0,267
338,154,5263,59,218,7,0,0,284
339,154,5264,67,183,3,5,0,258
340,154,5265,58,203,3,2,0,266
341,154,5266,82,171,2,4,1,260
342,154,5267,73,197,4,4,0,278
343,154,5268,61,207,3,7,0,278
344,154,5269,82,176,1,6,0,265
345,154,5270,74,193,0,5,0,272
346,154,5271,73,173,2,3,0,251
347,154,5272,45,201,2,1,0,249
348,154,5273,69,186,2,8,0,265
349,154,5274,48,196,4,10,0,258
350,154,5275,50,192,3,5,0,250
351,154,5276,97,165,1,4,1,268
352,154,5277,38,161,1,5,0,205
353,154,5278,60,189,7,7,0,263
354,149,5125,95,143,10,5,0,253
355,149,5126,114,144,5,6,0,269
356,156D,5455,59,227,0,6,0,292
357,156D,5456,58,222,2,5,0,287
358,156D,5457,80,189,0,8,0,277
359,156D,5458,62,213,5,8,0,288
360,156D,5459,57,215,2,9,0,283
361,156D,5460,80,200,4,3,0,287
362,156D,5461,75,197,1,13,0,286
363,156D,5462,64,215,2,4,0,285
364,156D,5463,72,202,6,7,0,287
365,156D,5464,80,197,2,1,0,280
366,156D,5465,65,206,0,6,0,277
367,156D,5466,62,210,3,9,0,284
368,156D,5467,76,192,2,5,0,275
369,158C,5517,92,158,0,4,0,254
370,158C,5518,72,180,2,5,0,259
371,158C,5519,78,179,4,5,0,266
372,158C,5520,56,201,1,3,0,261
373,158C,5521,73,174,1,4,0,252
374,158C,5522,88,164,5,4,0,261
375,158C,5523,79,166,2,4,0,251
376,158C,5524,87,176,2,2,0,267
377,157,5469,72,186,6,6,0,270
378,157,5470,80,176,2,4,0,262
379,157,5471,72,170,3,11,0,256
380,157,5472,69,189,8,0,0,266
381,157,5473,62,179,2,4,0,247
382,157,5474,78,169,6,0,0,253
383,157,5475,62,178,2,9,0,251
384,157,5476,54,199,1,3,0,257
385,157,5477,70,170,1,7,0,248
386,157,5478,76,157,4,4,0,241
387,157,5479,64,189,4,8,0,265
388,157,5480,58,191,3,7,0,259
389,157,5481,72,172,1,5,0,250
390,157,5482,83,171,6,8,0,268
391,157,5483,60,185,3,1,0,249
392,157,5484,69,180,4,2,0,255
393,157,5485,90,177,0,7,0,274
394,157,5486,66,170,1,8,0,245
395,157,5487,75,174,0,4,0,253
396,157,5488,65,179,2,4,0,250
397,157,5489,57,196,3,1,0,257
398,157,5490,61,182,14,0,0,257
399,157,5491,57,194,3,4,0,258
400,157,5492,66,195,2,2,0,265
401,158A,5511,65,106,3,2,0,176
402,158A,5512,62,112,1,1,0,176
403,147A,5085,74,153,1,4,0,232
404,147A,5086,72,153,2,8,0,235
405,147A,5087,72,151,2,6,0,231
406,147A,5088,72,146,1,7,0,226
407,148,5095,80,174,10,0,0,264
408,148,5096,102,139,7,3,0,251
409,148,5097,107,154,2,8,0,271
410,148,5098,97,155,4,2,0,258
411,148,5099,74,170,5,4,0,253
412,148,5100,83,158,0,5,0,246
413,148,5101,84,151,7,9,0,251
414,148,5102,78,168,3,6,0,255
415,148,5103,88,155,4,11,0,258
416,148,5104,81,137,5,13,1,237
417,148,5105,77,157,7,5,1,247
418,148,5106,102,158,2,5,0,267
419,148,5107,70,166,2,9,0,247
420,148,5108,80,172,4,4,0,260
421,148,5109,90,143,5,5,1,244
422,148,5110,69,179,1,6,0,255
423,148,5111,97,144,6,11,0,258
424,148,5112,83,164,1,8,1,257
425,148,5113,90,148,4,10,0,252
426,148,5114,106,166,1,3,0,276
427,148,5115,89,165,0,7,0,261
428,148,5116,88,167,3,4,0,262
429,148,5117,69,170,12,0,0,251
430,148,5118,83,167,3,7,0,260
431,148,5119,72,164,4,7,0,247
432,148,5120,100,165,4,5,0,274
433,148,5121,96,159,5,9,0,269
434,148,5122,90,156,1,5,0,252
435,148,5123,85,145,4,12,0,246
436,148,5124,89,165,5,14,0,273
437,159,5525,67,192,0,3,0,262
438,159,5526,71,184,3,8,0,266
439,159,5527,85,172,1,9,0,267
440,159,5528,89,161,0,5,0,255
441,159,5529,80,180,2,8,0,270
442,159,5530,80,171,1,5,0,257
443,159,5531,65,181,0,6,0,252
444,159,5532,76,169,4,3,0,252
445,159,5533,77,190,0,6,0,273
446,159,5534,69,171,2,15,0,257
447,159,5535,73,184,1,7,0,265
448,159,5536,84,174,3,10,1,272
449,159,5537,96,170,0,4,0,270
450,159,5538,64,190,4,8,0,266
451,159,5539,75,167,2,8,0,252
452,159,5540,59,179,3,10,0,251
453,155,5279,88,109,0,4,0,201
454,155,5280,109,98,2,0,0,209
455,155,5281,89,115,4,3,0,211
456,147,5068,76,178,4,0,0,258
457,147,5069,66,177,2,9,0,254
458,147,5070,71,192,1,2,0,266
459,147,5071,58,193,3,4,0,258
460,147,5072,75,183,3,1,0,262
461,147,5073,89,166,1,2,0,258
462,147,5074,63,183,1,4,0,251
463,147,5075,68,186,4,2,0,260
464,147,5076,56,190,3,2,0,251
465,147,5077,63,187,2,6,0,258
466,147,5078,77,188,1,3,0,269
467,147,5079,89,159,2,4,0,254
468,147,5080,74,190,2,6,0,272
469,147,5081,67,170,5,6,0,248
470,147,5082,70,178,3,3,0,254
471,147,5083,74,185,3,3,0,265
472,147,5084,72,180,3,1,0,256
473,211,6207,89,194,2,0,0,285
474,211,6208,65,202,3,6,0,276
475,211,6209,85,195,4,3,0,287
476,211,6210,44,238,1,4,0,287
477,211,6211,71,207,1,3,0,282
478,211,6212,58,224,1,3,0,286
479,211,6213,55,217,0,0,0,272
480,211,6214,61,203,0,7,0,271
481,211,6215,0,0,0,0,0,0
482,211,6216,73,211,1,2,0,287
483,211,6217,45,243,2,8,0,298
484,211,6218,83,195,2,2,0,282
485,211,6219,73,200,0,0,0,273
486,211,6220,74,203,0,6,0,283
487,211,6221,70,207,0,8,0,285
488,211,6222,63,218,3,4,0,288
489,211,6223,82,198,2,4,0,286
490,211,6224,67,206,2,7,0,282
491,211,6225,92,201,3,2,0,298
492,211,6226,85,198,1,7,0,291
493,211,6227,67,204,1,4,0,276
494,211,6228,61,217,1,2,0,281
495,211,6229,0,0,0,0,0,0
496,211,6230,59,218,3,0,0,280
497,211,6231,91,170,6,5,0,272
498,211,6232,66,215,0,3,0,284
499,211,6233,67,201,2,1,0,271
500,211,6234,79,193,2,4,0,278
501,222,6297,42,202,0,0,0,244
502,222,6298,49,195,7,0,0,251
503,222,6299,40,202,1,0,0,243
504,196,6171,38,143,0,2,0,183
505,207,6203,63,126,0,0,0,189
506,206,6202,1,45,0,0,0,46
507,212B,6236,66,142,2,1,0,211
508,199,6177,82,95,0,0,0,177
509,201A,6181,12,109,0,0,0,121
510,195,6170,45,72,1,1,0,119
511,209,6205,52,84,0,0,0,136
512,208,6204,70,164,1,1,0,236
513,210,6206,13,41,1,0,0,55
514,204,6185,63,192,2,3,0,260
515,204,6186,53,223,8,0,0,284
516,204,6187,55,207,3,3,0,268
517,204,6188,59,208,5,0,0,272
518,204,6189,82,183,0,7,0,272
519,204,6190,83,178,1,8,0,270
520,204,6191,54,188,6,0,0,248
521,204,6192,63,199,0,0,0,262
522,204,6193,72,178,6,0,0,256
523,204,6194,70,198,1,2,0,271
524,204,6195,63,192,4,0,0,259
525,197,6172,179,83,0,1,0,263
526,203,6183,75,86,0,2,0,163
527,203,6184,86,71,0,2,0,159
528,212,6235,43,66,1,0,0,110
529,198,6173,73,130,1,3,0,207
530,198,6174,71,137,2,0,0,210
531,198,6175,88,133,1,0,0,222
532,198,6176,75,139,2,3,0,219
533,205,6196,80,185,5,0,0,270
534,205,6197,68,208,5,0,0,281
535,205,6198,79,191,3,3,0,276
536,205,6199,75,191,8,0,0,274
537,205,6200,85,181,4,0,0,270
538,205,6201,69,212,4,0,0,285
539,214,6244,73,214,6,0,0,293
540,214,6245,103,171,3,6,0,283
541,214,6246,95,182,1,2,0,280
542,214,6247,91,186,4,0,0,281
543,214,6248,79,202,3,0,0,284
544,218,6253,99,176,0,4,0,279
545,218,6254,72,214,1,1,1,289
546,218,6255,72,206,0,0,0,278
547,218,6256,60,208,3,2,0,273
548,218,6257,88,188,3,0,0,279
549,218,6258,79,200,2,2,0,283
550,218,6259,46,220,2,6,0,274
551,218,6260,67,210,1,5,0,283
552,218,6261,71,201,8,0,0,280
553,218,6262,58,231,0,3,0,292
554,218,6263,64,210,1,2,0,277
555,218,6264,87,186,0,3,0,276
556,218,6265,74,206,6,2,0,288
557,218,6266,60,217,2,2,0,281
558,218,6267,57,214,4,1,0,276
559,218,6268,73,202,5,2,0,282
560,218,6269,58,207,3,4,0,272
561,218,6270,56,219,1,5,0,281
562,218,6271,61,217,5,0,0,283
563,218,6272,69,192,2,5,0,268
564,217,6252,22,38,0,0,0,60
565,216,6251,1,22,1,0,0,24
566,219,6273,32,108,4,0,0,144
567,202,6182,94,158,1,3,0,256
568,220,6274,95,166,2,2,0,265
569,220,6275,87,163,1,1,0,252
570,220,6276,73,199,1,2,0,275
571,220,6277,49,215,1,2,0,267
572,220,6278,88,159,7,2,0,256
573,220,6279,73,176,0,1,0,250
574,220,6280,90,174,0,1,0,265
575,220,6281,85,167,1,2,0,255
576,220,6282,63,181,1,2,0,247
577,220,6283,92,175,3,6,0,276
578,220,6284,72,167,1,4,0,244
579,220,6285,72,171,0,3,0,246
580,220,6286,78,176,3,6,0,263
581,220,6287,70,189,3,4,0,266
582,220,6288,68,169,1,4,0,242
583,220,6289,84,174,0,0,0,258
584,220,6290,95,177,1,1,0,274
585,220,6291,68,188,3,4,0,263
586,220,6292,75,201,0,2,0,278
587,220,6293,61,200,0,0,0,261
588,220,6294,68,191,1,3,0,263
589,220,6295,89,172,1,2,0,264
590,201,6180,32,55,1,0,0,88
591,215A,6250,52,159,1,1,0,213
592,200,6178,45,154,0,0,0,199
593,200,6179,53,143,0,0,0,196
594,213,6237,116,156,5,5,0,282
595,213,6238,91,165,2,3,0,261
596,213,6239,81,177,2,6,0,266
597,213,6240,88,169,4,4,0,265
598,213,6241,110,159,3,0,0,272
599,213,6242,92,157,2,6,0,257
600,213,6243,95,184,1,1,0,281
601,221,6296,28,59,1,0,0,88
602,215,6249,20,88,9,1,0,118
603,89,4263,88,184,1,2,0,275
604,89,4264,126,153,2,3,0,284
605,89,4265,133,133,3,2,0,271
606,89,4266,116,154,3,2,0,275
607,89,4267,112,160,2,7,0,281
608,89,4268,100,184,2,4,0,290
609,89,4269,86,169,1,5,0,261
610,89,4270,106,171,2,1,0,280
611,89,4271,105,154,6,4,0,269
612,89,4272,100,170,1,2,0,273
613,89,4273,105,160,1,1,0,267
614,89,4274,140,147,1,2,0,290
615,89,4275,121,157,1,5,0,284
616,89,4276,110,172,4,4,1,291
617,89,4277,102,182,3,1,0,288
618,89,4278,97,186,2,1,0,286
619,89,4279,94,190,2,2,0,288
620,89,4280,100,172,0,5,0,277
621,89,4281,120,148,3,4,0,275
622,89,4282,110,153,0,1,0,264
623,89,4283,117,163,1,3,0,284
624,89,4284,106,164,2,5,0,277
625,89,4285,84,176,5,3,0,268
626,89,4286,92,182,3,4,0,281
627,89,4287,69,219,0,2,0,290
628,89,4288,81,187,5,2,0,275
629,89,4289,74,211,2,6,0,293
630,89,4290,68,205,0,4,0,277
631,89,4291,61,207,3,3,0,274
632,89,4292,84,187,10,2,0,283
633,89,4293,101,170,0,4,0,275
634,89,4294,86,182,5,4,0,277
635,89,4295,87,203,4,4,0,298
636,89,4296,116,148,5,4,0,273
637,89,4297,120,162,5,3,0,290
638,89,4298,128,132,2,5,0,267
639,89,4299,100,174,2,5,0,281
640,89,4300,106,163,3,6,0,278
641,89,4301,89,167,4,1,0,261
642,89,4302,94,180,2,7,0,283
643,89,4303,0,0,0,0,0,0
644,89,4304,115,153,3,5,0,276
645,89,4305,119,158,2,7,0,286
646,89,4306,123,141,2,7,0,273
647,89,4307,112,176,4,1,0,293
648,89,4308,122,129,3,7,0,261
649,89,4309,122,145,7,7,9,290
650,89,4310,79,191,3,4,0,277
651,89,4311,104,174,3,3,0,284
652,89,4312,81,186,2,4,0,273
653,89,4313,103,180,5,4,0,292
654,89,4314,78,205,1,1,0,285
655,89,4315,78,179,3,6,1,267
656,89,4316,124,146,1,4,2,277
657,89,4317,97,185,0,3,0,285
658,89,4318,83,191,1,3,0,278
659,89,4319,104,156,3,1,2,266
660,89,4320,102,187,1,8,0,298
661,89,4321,87,174,4,8,0,273
662,89,4322,107,154,0,10,0,271
663,89,4323,87,184,3,2,0,276
664,89,4324,83,193,1,1,0,278
665,89,4325,136,128,1,3,1,269
666,89,4326,121,142,0,2,0,265
667,89,4327,119,154,3,5,0,281
668,89,4328,109,174,4,1,0,288
669,89,4329,113,141,3,4,0,261
670,89,4330,97,164,2,3,0,266
671,89,4331,110,167,2,5,0,284
672,89,4332,86,193,4,2,0,285
673,89,4333,96,163,1,2,0,262
674,89,4334,117,147,6,2,0,272
675,89,4335,90,181,1,4,0,276
676,89,4336,119,145,1,2,0,267
677,89,4337,100,168,1,3,0,272
678,89,4338,98,150,3,4,0,255
679,89,4339,89,195,4,4,0,292
680,89,4340,106,155,0,4,0,265
681,89,4341,96,177,3,3,0,279
682,89,4342,90,169,2,2,0,263
683,89,4343,98,174,3,8,0,283
684,89,4344,98,172,3,6,0,279
685,89,4345,114,169,4,4,0,291
686,89,4346,94,183,4,2,0,283
687,89,4347,104,170,3,5,0,282
688,89,4348,99,176,2,5,0,282
689,89,4349,93,187,2,2,0,284
690,89,4350,80,180,2,8,0,270
691,89,4351,109,167,13,0,0,289
692,89,4352,111,181,2,1,0,295
693,89,4353,126,150,1,7,0,284
694,89,4354,114,147,3,4,0,268
695,89,4355,114,151,6,10,0,281
696,89,4356,93,174,3,6,0,276
697,89,4357,64,213,1,4,0,282
698,89,4358,138,135,3,6,0,282
699,89,4359,98,171,1,3,0,273
700,89,4360,114,144,1,7,0,266
701,89,4361,115,146,3,8,0,272
702,89,4362,101,169,3,4,0,277
703,89,4363,99,163,1,5,0,268
704,89,4364,102,161,2,1,0,266
705,89,4365,109,154,5,7,0,275
706,89,4366,89,188,2,6,0,285
707,89,4367,95,176,6,3,0,280
708,89,4368,126,140,3,4,0,273
709,89,4369,130,129,1,7,0,267
710,89,4370,88,185,3,4,0,280
711,89,4371,107,168,2,1,0,278
712,89,4372,117,149,6,4,0,276
713,89,4373,110,154,2,0,0,266
714,89,4374,129,135,2,7,0,273
715,89,4375,114,155,5,4,0,278
716,89,4376,95,175,5,5,0,280
717,89,4377,101,174,6,4,1,286
718,89,4378,92,180,3,4,0,279
719,89,4379,81,202,0,3,1,287
720,89,4380,93,187,2,0,0,282
721,89,4381,113,171,3,5,0,292
722,89,4382,108,167,1,6,0,282
723,89,4383,98,182,2,8,1,291
724,89,4384,106,168,3,2,0,279
725,89,4385,100,164,0,8,0,272
726,89,4386,93,181,0,4,0,278
727,89,4387,112,143,3,1,0,259
728,89,4388,75,201,3,7,0,286
729,89,4389,100,169,2,3,0,274
730,89,4390,128,128,1,5,3,265
731,89,4391,94,178,2,2,0,276
732,89,4392,114,141,2,4,0,261
733,89,4393,102,173,1,0,0,276
734,89,4394,116,137,1,5,0,259
735,89,4395,117,156,6,4,0,283
736,89,4396,114,159,1,5,0,279
737,89,4397,114,160,3,2,0,279
738,89,4398,101,168,0,8,1,278
739,89,4399,106,154,1,7,0,268
740,89,4400,131,136,6,4,0,277
741,89,4401,109,165,7,3,0,284
742,89,4402,115,147,0,5,0,267
743,89,4403,108,151,4,3,0,266
744,89,4404,119,139,2,5,0,265
745,89,4405,120,141,1,10,0,272
746,89,4406,106,159,3,4,1,273
747,89,4407,64,195,4,7,0,270
748,89,4408,89,177,2,1,0,269
749,89,4409,124,147,4,3,0,278
750,89,4410,111,144,3,6,0,264
751,89,4411,123,151,1,5,0,280
752,89,4412,137,139,3,0,0,279
753,89,4413,108,167,2,1,0,278
754,89,4414,68,188,1,4,0,261
755,89,4415,107,172,1,2,0,282
756,89,4416,94,181,5,1,0,281
757,89,4417,127,159,2,4,0,292
758,89,4418,85,192,6,3,2,288
759,89,4419,116,148,1,4,1,270
760,89,4420,124,125,0,5,0,254
761,89,4421,102,161,2,4,0,269
762,89,4422,120,140,0,3,0,263
763,89,4423,71,203,0,9,0,283
764,89,4424,123,154,6,6,0,289
765,89,4425,120,149,2,5,0,276
766,89,4426,87,190,2,4,0,283
767,89,4427,114,156,4,1,0,275
768,89,4428,104,168,3,3,0,278
769,89,4429,130,145,1,5,0,281
770,89,4430,104,161,2,6,0,273
771,89,4431,123,146,4,2,0,275
772,89,4432,124,148,1,3,0,276
773,89,4433,95,180,3,2,0,280
774,89,4434,81,188,5,2,0,276
775,89,4435,105,165,5,2,0,277
776,89,4436,80,199,2,1,0,282
777,89,4437,120,163,4,0,0,287
778,89,4438,88,166,2,6,0,262
779,89,4439,122,141,3,6,0,272
780,89,4440,109,148,2,3,0,262
781,89,4441,111,147,7,8,0,273
782,89,4442,119,174,0,4,0,297
783,89,4443,115,152,2,2,0,271
784,89,4444,95,171,3,3,0,272
785,89,4445,94,184,3,5,0,286
786,89,4446,109,171,1,3,0,284
787,89,4447,115,146,4,4,0,269
788,89,4448,94,183,2,0,0,279
789,89,4449,120,147,2,4,0,273
790,89,4450,90,182,3,6,0,281
791,89,4451,94,177,5,6,0,282
792,89,4452,112,155,2,10,0,279
793,89,4453,98,169,4,8,0,279
794,89,4454,124,133,4,6,0,267
795,89,4455,104,177,2,4,0,287
796,89,4456,116,158,1,3,0,278
797,89,4457,112,171,3,5,0,291
798,89,4458,106,165,5,3,0,279
799,89,4459,109,165,4,0,0,278
800,89,4460,119,148,5,9,0,281
801,89,4461,101,185,1,2,0,289
802,89,4462,105,150,2,4,0,261
803,89,4463,110,141,3,3,0,257
804,89,4464,124,154,3,3,0,284
805,89,4465,100,179,4,2,0,285
806,89,4466,98,162,0,6,0,266
807,89,4467,81,170,3,2,0,256
808,89,4468,88,187,4,6,0,285
809,84,4242,6,17,3,0,0,26
810,87,4245,69,183,9,0,0,261
811,87,4246,72,193,5,0,0,270
812,87,4247,67,198,1,5,0,271
813,87,4248,71,193,2,4,0,270
814,87,4249,67,196,2,5,0,270
815,87,4250,77,178,3,2,0,260
816,90,4469,147,130,1,1,0,279
817,90,4470,141,142,5,2,0,290
818,90,4471,114,150,3,0,0,267
819,90,4472,134,135,3,2,0,274
820,90,4473,122,155,10,0,0,287
821,90,4474,133,147,7,2,0,289
822,90,4475,104,179,4,3,0,290
823,90,4476,101,185,7,2,0,295
824,90,4477,120,151,0,0,0,271
825,90,4478,115,158,2,1,0,276
826,90,4479,135,147,2,2,0,286
827,90,4480,128,138,1,6,0,273
828,90,4481,115,155,4,8,0,282
829,90,4482,128,143,3,5,0,279
830,90,4483,126,144,1,6,0,277
831,90,4484,135,122,6,1,0,264
832,90,4485,118,154,5,1,0,278
833,90,4486,0,0,0,0,0,0
834,90,4487,151,121,3,5,0,280
835,90,4488,130,159,3,4,0,296
836,90,4489,134,141,2,6,0,283
837,90,4490,93,189,3,2,0,287
838,90,4491,138,131,3,1,0,273
839,90,4492,118,159,2,5,0,284
840,90,4493,125,150,2,2,0,279
841,90,4494,151,123,3,2,0,279
842,90,4495,127,140,1,3,0,271
843,90,4496,137,128,3,4,0,272
844,90,4497,143,135,3,7,0,288
845,90,4498,103,167,3,3,0,276
846,90,4499,133,132,0,4,0,269
847,90,4500,136,137,2,4,0,279
848,90,4501,147,120,3,2,0,272
849,90,4502,126,156,3,5,0,290
850,90,4503,126,147,1,9,0,283
851,90,4504,127,132,3,4,0,266
852,90,4505,134,143,0,4,0,281
853,90,4506,104,166,9,0,0,279
854,90,4507,132,130,4,6,0,272
855,90,4508,143,140,3,7,0,293
856,90,4509,151,129,0,7,0,287
857,90,4510,143,127,2,4,0,276
858,90,4511,133,137,3,3,0,276
859,90,4512,118,148,2,4,0,272
860,90,4513,113,163,3,3,0,282
861,90,4514,124,142,2,9,0,277
862,90,4515,126,148,0,5,0,279
863,90,4516,132,137,3,2,0,274
864,90,4517,136,135,2,0,0,273
865,90,4518,130,118,3,9,0,260
866,90,4519,129,149,4,1,0,283
867,77,4209,105,180,2,6,0,293
868,77,4210,93,198,5,0,0,296
869,77,4211,80,193,0,4,0,277
870,77,4212,89,181,3,2,0,275
871,77,4213,80,198,1,0,0,279
872,77,4214,79,197,0,2,0,278
873,77,4215,94,189,0,8,0,291
874,77,4216,96,180,1,2,0,279
875,77,4217,126,149,0,7,0,282
876,77,4218,109,167,6,0,0,282
877,77,4219,118,164,4,0,0,286
878,088A,4261,0,0,0,0,0,0
879,088B,4262,1,3,0,1,0,5
880,76,4206,82,191,0,2,0,275
881,76,4207,70,196,3,5,0,274
882,76,4208,63,189,2,3,0,257
883,73,4189,85,145,6,0,0,236
884,73,4190,148,82,3,0,0,233
885,73,4191,86,137,0,1,0,224
886,73,4192,79,149,3,0,0,231
887,73,4193,76,144,1,1,0,222
888,74,4194,100,172,0,6,0,278
889,74,4195,61,214,6,0,0,281
890,74,4196,81,184,9,0,0,274
891,74,4197,85,190,0,3,0,278
892,74,4198,85,183,2,6,0,276
893,74,4199,94,174,9,0,0,277
894,74,4200,87,180,9,0,0,276
895,74,4201,72,203,5,0,0,280
896,74,4202,107,159,7,0,0,273
897,82,4236,90,122,10,0,0,222
898,82,4237,92,128,7,0,0,227
899,80,4233,62,176,2,0,0,240
900,80,4234,82,163,0,0,0,245
901,81,4235,14,39,0,0,0,53
902,75,4203,118,142,0,3,0,263
903,75,4204,96,159,4,2,0,261
904,75,4205,91,152,5,8,0,256
905,88,4251,84,158,2,5,0,249
906,88,4252,64,189,5,0,0,258
907,88,4253,80,172,0,1,0,253
908,88,4254,83,155,1,2,0,241
909,88,4255,67,167,2,2,0,238
910,88,4256,68,181,2,2,0,253
911,88,4257,74,173,4,6,0,257
912,88,4258,75,152,2,3,0,232
913,88,4259,70,163,4,4,0,241
914,88,4260,80,161,1,0,0,242
915,79,4224,93,151,1,2,0,247
916,79,4225,69,175,3,1,0,248
917,79,4226,94,156,0,1,0,251
918,79,4227,90,150,3,3,0,246
919,79,4228,71,161,5,0,0,237
920,79,4229,74,158,1,0,0,233
921,79,4230,67,174,7,0,0,248
922,79,4231,71,176,5,0,0,252
923,79,4232,82,157,6,0,0,245
924,86,4243,43,219,1,2,0,265
925,86,4244,64,183,1,9,0,257
926,78,4220,88,183,1,9,0,281
927,78,4221,74,200,0,1,0,275
928,78,4222,98,175,0,7,0,280
929,78,4223,82,186,1,1,0,270
930,83,4238,61,181,2,7,0,251
931,83,4239,71,172,1,3,0,247
932,83,4240,61,186,1,3,0,251
933,83,4241,76,153,3,3,0,235
934,116A,4741,19,78,1,1,0,99
935,113,4732,146,130,2,5,0,283
936,113,4733,130,146,4,0,0,280
937,102,4606,100,171,2,3,0,276
938,102,4607,96,161,2,3,0,262
939,102,4608,84,185,4,2,0,275
940,102,4609,68,215,0,4,0,287
941,102,4610,75,184,3,9,0,271
942,102,4611,76,191,0,11,0,278
943,102,4612,101,169,1,7,0,278
944,102,4613,83,174,3,3,0,263
945,102,4614,89,165,2,9,0,265
946,102,4615,94,171,7,0,0,272
947,102,4616,101,161,1,8,0,271
948,102,4617,81,171,3,2,0,257
949,102,4618,66,195,2,6,0,269
950,102,4619,85,168,7,2,0,262
951,102,4620,76,179,0,7,0,262
952,117,4742,119,132,2,2,0,255
953,117,4743,108,126,3,5,0,242
954,117,4744,101,154,3,3,0,261
955,117,4745,119,125,2,4,0,250
956,117,4746,126,117,5,0,0,248
957,117,4747,113,133,3,0,0,249
958,117,4748,124,119,4,0,0,247
959,110A,4695,15,39,1,0,0,55
960,110,4694,15,21,0,0,0,36
961,106,4625,83,173,5,0,0,261
962,106,4626,99,164,3,7,0,273
963,106,4627,79,191,1,1,0,272
964,106,4628,74,183,1,9,0,267
965,106,4629,57,211,3,0,0,271
966,106,4630,65,199,5,0,0,269
967,106,4631,70,189,1,0,0,260
968,106,4632,85,189,7,6,0,287
969,106,4633,70,204,2,2,0,278
970,106,4634,71,197,2,2,0,272
971,106,4635,71,173,2,10,0,256
972,106,4636,99,170,1,3,0,273
973,106,4637,73,199,2,2,0,276
974,106,4638,81,173,3,6,0,263
975,106,4639,82,181,8,0,0,271
976,106,4640,92,159,2,8,0,261
977,106,4641,75,202,4,2,0,283
978,106,4642,71,183,6,0,0,260
979,106,4643,64,206,1,6,0,277
980,106,4644,84,181,2,10,0,277
981,106,4645,101,157,2,5,0,265
982,106,4646,80,180,1,6,0,267
983,106,4647,84,170,0,6,0,260
984,106,4648,68,202,7,0,0,277
985,106,4649,88,166,3,2,0,259
986,106,4650,83,160,2,2,0,247
987,106,4651,62,202,2,3,0,269
988,106,4652,65,193,2,3,0,263
989,106,4653,101,168,6,4,0,279
990,106,4654,88,167,1,3,0,259
991,106,4655,111,156,1,4,0,272
992,109,4666,74,182,3,10,0,269
993,109,4667,77,208,2,8,0,295
994,109,4668,77,196,3,4,0,280
995,109,4669,59,222,2,0,0,283
996,109,4670,60,198,2,8,0,268
997,109,4671,77,202,1,4,0,284
998,109,4672,54,222,13,0,0,289
999,109,4673,71,207,2,3,0,283
1000,109,4674,63,195,4,5,0,267
1001,109,4675,66,205,4,7,0,282
1002,109,4676,66,210,2,4,0,282
1003,109,4677,76,204,9,0,0,289
1004,109,4678,72,209,4,5,0,290
1005,109,4679,60,227,3,4,0,294
1006,109,4680,80,194,2,10,0,286
1007,109,4681,54,229,1,6,0,290
1008,109,4682,73,193,1,2,0,269
1009,109,4683,54,213,13,0,0,280
1010,109,4684,82,189,3,2,0,276
1011,109,4685,91,170,4,6,0,271
1012,109,4686,46,227,5,4,0,282
1013,109,4687,65,210,1,3,0,279
1014,109,4688,77,192,3,5,0,277
1015,109,4689,66,194,5,2,0,267
1016,109,4690,77,192,11,0,0,280
1017,109,4691,62,209,5,4,0,280
1018,109,4692,59,204,2,4,0,269
1019,109,4693,73,200,3,6,0,282
1020,116,4736,88,135,1,0,0,224
1021,116,4737,95,124,5,0,0,224
1022,116,4738,94,113,2,0,0,209
1023,116,4739,75,135,2,0,0,212
1024,116,4740,93,124,4,0,0,221
1025,114,4734,49,222,1,1,0,273
1026,114,4735,34,230,3,4,0,271
1027,103,4621,16,38,0,0,0,54
1028,112,4700,89,196,9,0,0,294
1029,112,4701,99,181,1,2,0,283
1030,112,4702,102,171,1,2,0,276
1031,112,4703,73,181,2,7,0,263
1032,112,4704,73,185,2,10,0,270
1033,112,4705,99,162,2,7,0,270
1034,112,4706,70,193,2,6,0,271
1035,112,4707,103,173,3,7,0,286
1036,112,4708,86,185,0,5,0,276
1037,112,4709,64,219,2,2,0,287
1038,112,4710,86,172,5,3,0,266
1039,112,4711,100,168,0,2,0,270
1040,112,4712,99,168,1,4,0,272
1041,112,4713,85,170,1,6,0,262
1042,112,4714,101,174,6,2,0,283
1043,112,4715,79,183,4,0,0,266
1044,112,4716,111,139,2,4,0,256
1045,112,4717,114,160,1,7,0,282
1046,112,4718,93,183,1,3,0,280
1047,112,4719,82,189,5,6,0,282
1048,112,4720,101,166,2,6,0,275
1049,112,4721,102,163,5,6,0,276
1050,112,4722,89,173,3,5,0,270
1051,112,4723,77,195,4,2,0,278
1052,112,4724,105,164,2,9,0,280
1053,112,4725,107,171,3,2,0,283
1054,112,4726,93,177,1,4,0,275
1055,112,4727,92,174,1,8,0,275
1056,112,4728,93,168,1,3,0,265
1057,112,4729,104,161,4,4,0,273
1058,112,4730,89,187,1,4,0,281
1059,112,4731,91,170,1,4,0,266
1060,107,4656,64,200,8,0,0,272
1061,107,4657,83,187,0,1,0,271
1062,107,4658,93,167,3,3,0,266
1063,107,4659,114,133,2,3,0,252
1064,107,4660,95,158,3,0,0,256
1065,107,4661,96,160,9,0,0,265
1066,118,4749,62,203,0,2,0,267
1067,118,4750,67,200,2,0,0,269
1068,118,4751,58,206,1,4,0,269
1069,118,4752,78,172,1,2,0,253
1070,118,4753,78,183,1,3,0,265
1071,118,4754,60,199,1,3,0,263
1072,118,4755,80,170,1,6,0,257
1073,118,4756,65,175,5,5,0,250
1074,118,4757,73,191,2,5,0,271
1075,118,4758,67,187,2,0,0,256
1076,118,4759,65,184,5,0,0,254
1077,118,4760,51,205,3,0,0,259
1078,118,4761,68,172,4,0,0,244
1079,118,4762,69,147,2,4,0,222
1080,118,4763,85,174,4,0,0,263
1081,105,4622,71,197,9,0,0,277
1082,105,4623,83,174,10,0,0,267
1083,105,4624,76,189,11,0,0,276
1084,111,4696,40,190,1,2,0,233
1085,111,4697,47,181,1,3,0,232
1086,111,4698,71,142,0,5,0,218
1087,111,4699,53,176,1,2,0,232
1088,108,4662,60,160,3,2,0,225
1089,108,4663,49,169,1,4,0,223
1090,108,4664,65,154,1,4,0,224
1091,108,4665,61,149,3,1,0,214
1092,189,6130,84,179,1,4,0,268
1093,189,6131,60,205,2,0,0,267
1094,189,6132,38,233,3,0,0,274
1095,189,6133,33,230,1,3,0,267
1096,189,6134,60,198,0,2,0,260
1097,189,6135,91,164,3,6,0,264
1098,189,6136,45,230,1,3,0,279
1099,189,6137,82,170,1,4,0,257
1100,189,6138,97,161,1,9,0,268
1101,189,6139,67,189,0,6,0,262
1102,189,6140,86,182,0,4,0,272
1103,189,6141,65,176,1,5,0,247
1104,189,6142,66,200,3,4,0,273
1105,189,6143,60,203,0,4,0,267
1106,189,6144,80,197,5,0,0,282
1107,189,6145,67,205,1,3,0,276
1108,189,6146,73,181,0,5,0,259
1109,189,6147,60,196,2,3,0,261
1110,189,6148,52,215,3,4,0,274
1111,189,6149,75,192,0,4,0,271
1112,189,6150,0,0,0,0,0,0
1113,189,6151,74,184,4,4,0,266
1114,173,5735,0,10,0,0,0,10
1115,178A,5750,62,105,1,0,0,168
1116,178A,5751,55,109,0,0,2,166
1117,170,5711,74,188,1,5,0,268
1118,170,5712,31,231,0,3,0,265
1119,170,5713,57,193,5,0,0,255
1120,170,5714,61,205,7,0,0,273
1121,170,5715,72,187,4,0,0,263
1122,170,5716,70,187,3,0,0,260
1123,170,5717,60,181,1,8,0,250
1124,170,5718,52,193,4,0,0,249
1125,170,5719,62,198,11,0,0,271
1126,191A,6163,76,173,3,2,0,254
1127,171,5720,32,65,0,0,0,97
1128,174,5736,61,133,2,0,0,196
1129,174,5737,67,118,3,0,0,188
1130,174,5738,78,127,1,3,0,209
1131,181,5772,25,103,5,1,0,134
1132,175,5739,20,34,0,1,0,55
1133,193,6166,108,102,1,2,0,213
1134,193,6167,105,113,2,0,0,220
1135,188,5906,57,213,2,2,0,274
1136,188,5907,85,183,3,5,0,276
1137,188,5908,87,166,2,10,0,265
1138,188,5909,94,159,2,8,0,263
1139,188,5910,86,188,3,4,0,281
1140,188,5911,90,169,6,8,0,273
1141,188,5912,84,184,3,3,0,274
1142,188,5913,78,172,4,5,0,259
1143,188,5914,61,204,8,6,0,279
1144,188,5915,70,190,5,8,0,273
1145,188,5916,77,176,2,11,0,266
1146,188,5917,63,197,2,4,0,266
1147,188,5918,74,189,2,14,0,279
1148,188,5919,82,175,3,0,0,260
1149,188,5920,75,179,2,1,5,262
1150,188,5921,64,200,4,4,0,272
1151,188,5922,64,201,3,4,0,272
1152,188,5923,92,180,2,7,0,281
1153,188,5924,64,206,2,6,4,282
1154,188,5925,60,202,6,8,0,276
1155,188,5926,74,187,3,7,0,271
1156,188,5927,78,199,4,3,0,284
1157,188,5928,74,181,1,4,0,260
1158,188,5929,72,190,0,5,0,267
1159,188,5930,57,200,6,7,0,270
1160,188,5931,58,217,3,5,0,283
1161,188,5932,52,216,0,1,0,269
1162,188,5933,49,216,4,4,0,273
1163,188,5934,72,190,8,2,0,272
1164,188,5935,53,228,1,6,0,288
1165,188,5936,52,234,4,1,0,291
1166,188,5937,65,217,6,4,0,292
1167,188,5938,77,189,1,7,0,274
1168,188,5939,75,196,2,9,0,282
1169,188,5940,48,207,2,6,0,263
1170,188,5941,67,208,0,1,1,277
1171,188,5942,85,187,2,4,0,278
1172,188,5943,71,189,5,4,1,270
1173,188,5944,54,228,1,7,0,290
1174,188,5945,74,186,2,3,0,265
1175,188,5946,58,216,4,7,0,285
1176,188,5947,59,209,1,5,0,274
1177,188,5948,76,181,1,1,2,261
1178,188,5949,70,213,2,3,0,288
1179,188,5950,90,191,0,3,0,284
1180,188,5951,66,193,8,12,0,279
1181,188,5952,81,183,2,1,0,267
1182,188,5953,72,181,1,4,0,258
1183,188,5954,83,173,5,0,0,261
1184,188,5955,73,195,2,1,0,271
1185,188,5956,85,192,2,7,0,286
1186,188,5957,65,215,7,3,0,290
1187,188,5958,62,222,4,2,0,290
1188,188,5959,47,230,1,2,0,280
1189,188,5960,84,196,0,1,0,281
1190,188,5961,88,183,2,2,0,275
1191,188,5962,65,202,2,2,0,271
1192,188,5963,44,224,5,3,0,276
1193,188,5964,60,188,1,7,0,256
1194,188,5965,59,203,4,9,0,275
1195,188,5966,46,244,7,3,0,300
1196,188,5967,68,206,1,5,0,280
1197,188,5968,68,206,4,1,0,279
1198,188,5969,58,218,4,4,0,284
1199,188,5970,62,207,4,4,0,277
1200,188,5971,76,188,2,2,0,268
1201,188,5972,77,175,2,7,0,261
1202,188,5973,61,221,4,1,0,287
1203,188,5974,84,186,0,6,0,276
1204,188,5975,64,205,2,6,0,277
1205,188,5976,52,223,4,2,0,281
1206,188,5977,101,160,1,1,0,263
1207,188,5978,66,202,1,6,0,275
1208,188,5979,50,222,5,8,0,285
1209,188,5980,80,190,5,0,0,275
1210,188,5981,54,212,5,13,0,284
1211,188,5982,80,182,0,6,0,268
1212,188,5983,80,193,5,3,1,282
1213,188,5984,60,198,3,4,0,265
1214,188,5985,78,182,1,10,0,271
1215,188,5986,55,198,1,6,0,260
1216,188,5987,72,175,3,18,0,268
1217,188,5988,65,211,2,4,0,282
1218,188,5989,66,197,4,12,1,280
1219,188,5990,85,183,3,6,0,277
1220,188,5991,49,227,1,5,0,282
1221,188,5992,80,177,5,6,0,268
1222,188,5993,88,196,6,4,0,294
1223,188,5994,71,185,2,13,0,271
1224,188,5995,71,203,2,4,0,280
1225,188,5996,71,190,2,4,0,267
1226,188,5997,52,212,7,7,0,278
1227,188,5998,52,241,1,3,0,297
1228,188,5999,77,193,3,3,0,276
1229,188,6000,45,238,1,2,0,286
1230,188,6001,70,193,8,7,0,278
1231,188,6002,70,183,4,5,0,262
1232,188,6003,85,188,3,4,0,280
1233,188,6004,75,193,2,7,0,277
1234,188,6005,90,189,1,9,0,289
1235,188,6006,85,181,1,7,0,274
1236,188,6007,71,206,4,3,0,284
1237,188,6008,54,219,3,1,0,277
1238,188,6009,61,209,0,2,0,272
1239,188,6010,78,186,5,7,0,276
1240,188,6011,57,193,2,11,0,263
1241,188,6012,104,172,3,4,0,283
1242,188,6013,67,192,4,11,0,274
1243,188,6014,72,186,5,12,0,275
1244,188,6015,91,176,2,3,0,272
1245,188,6016,69,188,2,8,0,267
1246,188,6017,37,224,4,4,0,269
1247,188,6018,59,205,2,6,0,272
1248,188,6019,64,192,7,4,0,267
1249,188,6020,76,185,3,8,0,272
1250,188,6021,83,183,5,11,0,282
1251,188,6022,63,208,6,3,0,280
1252,188,6023,76,183,5,1,0,265
1253,188,6024,75,180,1,4,0,260
1254,188,6025,71,195,2,6,0,274
1255,188,6026,88,162,2,3,0,255
1256,188,6027,75,175,1,4,0,255
1257,188,6028,77,180,6,4,0,267
1258,188,6029,75,195,2,4,0,276
1259,188,6030,58,211,8,9,0,286
1260,188,6031,78,182,11,8,0,279
1261,188,6032,73,190,4,5,0,272
1262,188,6033,67,212,7,3,0,289
1263,188,6034,70,195,2,2,0,269
1264,188,6035,67,202,0,3,0,272
1265,188,6036,68,196,4,6,0,274
1266,188,6037,49,224,5,1,0,279
1267,188,6038,87,194,4,5,0,290
1268,188,6039,85,187,0,3,0,275
1269,188,6040,58,214,1,2,0,275
1270,188,6041,67,199,1,3,0,270
1271,188,6042,57,206,1,6,0,270
1272,188,6043,82,183,2,8,0,275
1273,188,6044,65,190,6,6,0,267
1274,188,6045,77,190,6,5,0,278
1275,188,6046,91,178,1,5,0,275
1276,188,6047,85,179,3,6,0,273
1277,188,6048,74,186,3,4,0,267
1278,188,6049,67,195,2,6,0,270
1279,188,6050,73,197,2,3,0,275
1280,188,6051,70,225,0,1,0,296
1281,188,6052,58,220,3,4,0,285
1282,188,6053,77,187,2,4,0,270
1283,188,6054,94,168,2,4,0,268
1284,188,6055,91,182,2,4,0,279
1285,188,6056,74,190,0,7,0,271
1286,188,6057,80,178,2,2,0,262
1287,188,6058,76,183,6,10,0,275
1288,188,6059,80,199,4,5,0,288
1289,188,6060,69,200,2,2,0,273
1290,188,6061,86,170,3,5,0,264
1291,188,6062,66,195,2,6,0,269
1292,188,6063,76,175,0,8,0,259
1293,188,6064,62,201,7,7,0,277
1294,188,6065,71,193,2,5,0,271
1295,188,6066,57,215,1,1,0,274
1296,188,6067,63,200,2,11,0,276
1297,188,6068,80,174,2,3,0,259
1298,188,6069,87,155,2,8,0,252
1299,188,6070,82,180,4,3,0,269
1300,188,6071,81,180,6,1,0,268
1301,188,6072,65,195,3,8,0,271
1302,188,6073,46,235,1,1,0,283
1303,188,6074,68,195,6,6,0,275
1304,188,6075,40,217,2,5,0,264
1305,188,6076,63,202,7,6,0,278
1306,188,6077,61,208,2,5,0,276
1307,188,6078,56,204,1,3,0,264
1308,188,6079,89,146,6,7,0,248
1309,188,6080,62,185,3,10,0,260
1310,188,6081,70,186,4,9,0,269
1311,188,6082,46,225,3,4,0,278
1312,188,6083,74,207,2,3,0,286
1313,188,6084,54,205,2,8,0,269
1314,188,6085,65,222,2,3,1,293
1315,188,6086,79,184,0,3,0,266
1316,188,6087,63,190,2,15,0,270
1317,188,6088,97,170,2,11,0,280
1318,188,6089,89,164,6,13,0,272
1319,188,6090,85,181,6,7,0,279
1320,188,6091,78,195,4,3,0,280
1321,188,6092,102,167,1,6,0,276
1322,188,6093,73,176,2,12,0,263
1323,188,6094,58,211,4,4,0,277
1324,188,6095,59,217,4,6,0,286
1325,188,6096,78,181,4,13,0,276
1326,188,6097,89,177,3,4,0,273
1327,188,6098,67,194,2,4,0,267
1328,188,6099,68,218,2,3,0,291
1329,188,6100,80,181,8,6,0,275
1330,188,6101,46,224,5,4,0,279
1331,188,6102,52,213,5,8,0,278
1332,188,6103,72,194,3,6,0,275
1333,188,6104,59,194,5,7,0,265
1334,188,6105,82,186,3,5,0,276
1335,188,6106,86,169,3,6,0,264
1336,188,6107,74,193,1,5,0,273
1337,188,6108,67,217,1,5,0,290
1338,188,6109,66,184,1,11,0,262
1339,188,6110,43,229,2,3,0,277
1340,188,6111,81,175,5,6,0,267
1341,188,6112,85,187,3,3,0,278
1342,188,6113,95,153,7,11,0,266
1343,188,6114,85,161,2,6,0,254
1344,188,6115,96,162,7,0,0,265
1345,188,6116,65,215,2,3,0,285
1346,188,6117,70,165,6,5,8,254
1347,188,6118,64,200,7,6,0,277
1348,188,6119,77,192,2,7,0,278
1349,188,6120,80,174,2,10,0,266
1350,188,6121,72,186,4,5,0,267
1351,188,6122,59,200,3,2,0,264
1352,188,6123,66,195,5,3,0,269
1353,188,6124,101,172,1,9,0,283
1354,188,6125,49,218,4,0,0,271
1355,188,6126,46,213,3,5,0,267
1356,188,6127,73,182,3,6,0,264
1357,188,6128,72,194,6,3,0,275
1358,188,6129,79,208,6,2,0,295
1359,178B,5752,34,65,1,1,0,101
1360,164,5589,96,145,2,1,0,244
1361,164,5590,95,151,2,1,0,249
1362,164,5591,113,122,1,2,0,238
1363,164,5592,101,144,1,3,0,249
1364,164,5593,84,171,4,2,0,261
1365,164,5594,88,159,3,2,0,252
1366,179,5753,80,207,6,0,0,293
1367,179,5754,74,203,6,10,0,293
1368,179,5755,74,197,11,4,0,286
1369,179,5756,72,201,6,6,0,285
1370,179,5757,83,197,3,7,0,290
1371,179,5758,70,209,4,3,0,286
1372,179,5759,54,213,1,3,0,271
1373,179,5760,67,209,3,6,0,285
1374,179,5761,64,206,4,4,0,278
1375,179,5762,90,197,3,5,0,295
1376,179,5763,63,213,3,7,0,286
1377,179,5764,69,194,4,9,0,276
1378,179,5765,86,190,3,4,0,283
1379,179,5766,84,199,4,7,0,294
1380,179,5767,72,210,3,3,0,288
1381,179,5768,87,203,2,6,0,298
1382,179,5769,81,199,1,0,0,281
1383,179,5770,79,203,3,6,0,291
1384,160,5541,104,144,1,2,0,251
1385,160,5542,115,139,0,3,0,257
1386,160,5543,93,165,2,2,0,262
1387,160,5544,98,165,5,3,0,271
1388,160,5545,105,162,1,0,0,268
1389,160,5546,101,162,1,0,0,264
1390,160,5547,99,161,2,4,0,266
1391,160,5548,93,163,3,5,0,264
1392,180,5771,13,157,6,3,0,179
1393,187,5905,24,44,1,2,0,71
1394,163,5585,70,154,6,0,0,230
1395,163,5586,73,161,2,2,0,238
1396,163,5587,67,172,3,2,0,244
1397,163,5588,68,155,0,0,0,223
1398,166,5683,77,200,1,0,0,278
1399,166,5684,98,163,8,0,0,269
1400,166,5685,44,215,4,2,0,265
1401,166,5686,91,145,2,6,0,244
1402,166,5687,59,207,9,3,0,278
1403,166,5688,72,198,0,2,0,272
1404,166,5689,49,205,2,3,0,259
1405,166,5690,64,195,1,4,0,264
1406,166,5691,72,170,7,0,0,249
1407,166,5692,80,175,5,9,0,269
1408,166,5693,58,200,3,0,0,261
1409,166,5694,62,196,3,1,0,262
1410,166,5695,94,165,11,0,0,270
1411,166,5696,66,208,3,6,0,283
1412,166,5697,71,189,9,0,0,269
1413,166,5698,88,177,9,0,0,274
1414,166,5699,82,194,6,0,0,282
1415,166,5700,83,178,0,0,0,261
1416,166,5701,64,207,0,8,0,279
1417,165,5595,93,176,3,3,0,275
1418,165,5596,109,154,6,5,0,274
1419,165,5597,101,168,2,4,0,275
1420,165,5598,111,168,2,2,0,283
1421,165,5599,122,157,2,7,0,288
1422,165,5600,96,180,6,0,0,282
1423,165,5601,102,165,4,3,0,274
1424,165,5602,99,177,5,5,0,286
1425,165,5603,76,197,4,11,0,288
1426,165,5604,73,206,2,8,0,289
1427,165,5605,85,192,2,5,0,284
1428,165,5606,91,190,3,7,0,291
1429,165,5607,72,213,4,8,0,297
1430,165,5608,91,176,2,4,4,277
1431,165,5609,77,184,4,6,0,271
1432,165,5610,87,170,7,6,0,270
1433,165,5611,78,195,4,10,0,287
1434,165,5612,66,206,2,11,0,285
1435,165,5613,99,159,0,5,0,263
1436,165,5614,90,182,3,10,1,286
1437,165,5615,58,214,3,5,0,280
1438,165,5616,71,184,6,10,0,271
1439,165,5617,96,169,0,6,0,271
1440,165,5618,86,176,1,3,0,266
1441,165,5619,77,205,4,4,0,290
1442,165,5620,72,201,3,11,0,287
1443,165,5621,86,184,4,0,0,274
1444,165,5622,91,191,2,3,0,287
1445,165,5623,85,169,4,11,0,269
1446,165,5624,75,182,11,0,0,268
1447,165,5625,68,207,2,6,0,283
1448,165,5626,93,159,2,8,0,262
1449,165,5627,93,181,4,3,0,281
1450,165,5628,93,175,3,4,0,275
1451,165,5629,96,165,5,3,0,269
1452,165,5630,91,183,4,4,0,282
1453,165,5631,81,178,7,9,0,275
1454,165,5632,93,178,5,10,0,286
1455,165,5633,102,161,2,8,0,273
1456,165,5634,100,163,5,3,0,271
1457,165,5635,76,186,3,7,0,272
1458,165,5636,98,165,2,9,0,274
1459,165,5637,72,188,2,8,0,270
1460,165,5638,77,192,4,6,0,279
1461,165,5639,101,167,5,6,0,279
1462,165,5640,93,170,2,10,0,275
1463,165,5641,93,186,5,2,0,286
1464,165,5642,0,0,0,0,0,0
1465,165,5643,76,189,3,4,0,272
1466,165,5644,80,202,1,1,0,284
1467,165,5645,69,205,2,7,0,283
1468,165,5646,88,198,0,3,0,289
1469,165,5647,84,186,0,4,0,274
1470,165,5648,84,182,2,6,0,274
1471,165,5649,93,173,2,4,0,272
1472,165,5650,106,137,0,8,0,251
1473,165,5651,108,166,3,5,0,282
1474,165,5652,108,157,1,5,0,271
1475,165,5653,93,162,2,5,0,262
1476,165,5654,86,167,0,8,0,261
1477,165,5655,104,151,2,5,0,262
1478,165,5656,96,172,2,4,0,274
1479,165,5657,0,0,0,0,0,0
1480,165,5658,74,179,3,9,0,265
1481,165,5659,111,142,5,3,0,261
1482,165,5660,90,196,6,2,0,294
1483,165,5661,87,179,7,8,0,281
1484,165,5662,100,187,5,4,0,296
1485,165,5663,110,167,1,3,0,281
1486,165,5664,80,185,2,7,0,274
1487,165,5665,79,189,2,3,0,273
1488,165,5666,107,161,3,4,0,275
1489,165,5667,120,144,2,6,0,272
1490,165,5668,81,177,0,8,0,266
1491,165,5669,89,172,3,6,0,270
1492,165,5670,81,183,7,7,0,278
1493,165,5671,100,176,5,5,0,286
1494,165,5672,67,210,2,8,0,287
1495,165,5673,99,168,2,5,0,274
1496,165,5674,92,175,2,10,0,279
1497,165,5675,73,208,1,9,0,291
1498,165,5676,74,192,2,5,0,273
1499,165,5677,103,160,2,1,0,266
1500,165,5678,88,177,3,7,0,275
1501,165,5679,78,185,0,9,0,272
1502,165,5680,87,185,8,5,0,285
1503,165,5681,91,192,4,3,0,290
1504,165,5682,89,187,4,4,0,284
1505,160A,5549,13,206,1,4,0,224
1506,194,6168,102,106,0,1,0,209
1507,194,6169,81,127,1,0,0,209
1508,167,5702,47,179,2,2,0,230
1509,167,5703,69,152,9,0,0,230
1510,167,5704,65,160,3,0,0,228
1511,167,5705,61,166,6,0,0,233
1512,190,6152,10,89,0,1,0,100
1513,176,5740,7,42,1,0,0,50
1514,184A,5827,45,229,1,1,0,276
1515,184A,5828,41,218,3,5,0,267
1516,185,5829,0,1,0,0,0,1
1517,186,5830,116,141,1,10,0,268
1518,186,5831,111,155,0,4,0,270
1519,186,5832,105,141,1,6,0,253
1520,186,5833,94,166,0,9,0,269
1521,186,5834,106,159,3,11,0,279
1522,186,5835,85,163,3,4,0,255
1523,186,5836,104,151,3,8,0,266
1524,186,5837,97,158,1,14,0,270
1525,186,5838,86,165,2,7,0,260
1526,186,5839,77,189,4,5,0,275
1527,186,5840,70,173,3,6,0,252
1528,186,5841,95,180,2,8,1,286
1529,186,5842,92,153,1,9,0,255
1530,186,5843,77,180,1,8,0,266
1531,186,5844,116,163,0,1,0,280
1532,186,5845,93,165,4,7,0,269
1533,186,5846,102,150,1,7,0,260
1534,186,5847,123,127,1,6,0,257
1535,186,5848,84,163,3,12,0,262
1536,186,5849,107,159,2,8,1,277
1537,186,5850,101,170,2,6,0,279
1538,186,5851,85,176,5,7,0,273
1539,186,5852,95,169,6,7,0,277
1540,186,5853,88,182,3,3,0,276
1541,186,5854,127,155,4,2,0,288
1542,186,5855,97,158,5,5,0,265
1543,186,5856,106,154,1,8,0,269
1544,186,5857,95,165,4,7,0,271
1545,186,5858,105,160,0,5,0,270
1546,186,5859,93,146,2,11,0,252
1547,186,5860,114,156,6,7,0,283
1548,186,5861,108,148,7,5,0,268
1549,186,5862,108,149,2,8,0,267
1550,186,5863,103,153,2,4,0,262
1551,186,5864,97,146,4,17,0,264
1552,186,5865,96,159,4,3,0,262
1553,186,5866,97,151,5,10,0,263
1554,186,5867,83,178,2,6,0,269
1555,186,5868,92,167,2,11,0,272
1556,186,5869,170,84,3,5,0,262
1557,186,5870,97,164,2,6,0,269
1558,186,5871,99,155,5,6,0,265
1559,186,5872,107,160,2,7,0,276
1560,186,5873,85,160,1,3,0,249
1561,186,5874,97,156,3,6,0,262
1562,186,5875,119,149,4,6,0,278
1563,186,5876,119,144,2,6,0,271
1564,186,5877,105,144,2,8,0,259
1565,186,5878,87,160,2,11,0,260
1566,186,5879,105,169,4,6,0,284
1567,186,5880,87,151,6,10,0,254
1568,186,5881,103,136,4,6,0,249
1569,186,5882,89,176,1,6,0,272
1570,186,5883,90,168,2,11,0,271
1571,186,5884,101,164,3,2,0,270
1572,186,5885,112,143,2,5,0,262
1573,186,5886,93,176,4,10,0,283
1574,186,5887,86,172,1,5,0,264
1575,186,5888,104,147,5,13,0,269
1576,186,5889,96,150,3,10,0,259
1577,186,5890,98,163,1,5,0,267
1578,186,5891,111,144,4,9,0,268
1579,186,5892,103,141,3,8,0,255
1580,186,5893,105,162,3,5,0,275
1581,186,5894,97,166,5,6,0,274
1582,186,5895,85,166,1,7,0,259
1583,186,5896,86,168,2,6,0,262
1584,186,5897,118,141,1,8,0,268
1585,186,5898,105,159,6,4,0,274
1586,186,5899,108,151,5,10,0,274
1587,186,5900,124,146,4,10,0,284
1588,186,5901,88,166,1,10,0,265
1589,186,5902,101,142,0,7,0,250
1590,186,5903,91,173,8,3,0,275
1591,186,5904,100,155,3,9,0,267
1592,172,5721,75,195,2,6,0,278
1593,172,5722,88,184,2,2,0,276
1594,172,5723,51,216,3,1,0,271
1595,172,5724,83,177,4,10,0,274
1596,172,5725,59,194,8,0,0,261
1597,172,5726,59,207,1,7,0,274
1598,172,5727,61,191,3,5,0,260
1599,172,5728,48,222,2,0,0,272
1600,172,5729,67,200,4,2,0,273
1601,172,5730,65,190,4,2,3,264
1602,172,5731,54,204,1,3,0,262
1603,172,5732,75,187,1,1,0,264
1604,172,5733,59,213,3,7,0,282
1605,172,5734,79,178,11,0,0,268
1606,177,5741,92,156,1,2,0,251
1607,177,5742,102,135,2,6,0,245
1608,177,5743,110,143,0,2,0,255
1609,177,5744,102,138,1,4,0,245
1610,177,5745,110,148,4,9,0,271
1611,177,5746,97,163,2,3,0,265
1612,177,5747,106,144,1,0,0,251
1613,177,5748,97,156,2,5,0,260
1614,192,6164,25,175,2,0,0,202
1615,192,6165,30,152,2,4,0,188
1616,191,6153,72,192,2,3,0,269
1617,191,6154,50,218,3,0,0,271
1618,191,6155,79,188,2,2,0,271
1619,191,6156,58,195,3,0,0,256
1620,191,6157,81,165,2,1,0,249
1621,191,6158,76,180,13,0,0,269
1622,191,6159,84,180,1,3,0,268
1623,191,6160,58,204,2,8,0,272
1624,191,6161,71,183,2,2,0,258
1625,191,6162,60,196,5,3,0,264
1626,161,5550,95,162,9,0,0,266
1627,161,5551,43,202,4,7,0,256
1628,161,5552,47,215,4,3,0,269
1629,161,5553,75,177,10,0,0,262
1630,161,5554,56,198,1,1,0,256
1631,161,5555,69,192,11,0,0,272
1632,161,5556,60,195,2,7,0,264
1633,161,5557,53,193,1,2,0,249
1634,161,5558,85,160,5,0,0,250
1635,161,5559,81,187,3,5,0,276
1636,161,5560,68,183,4,0,1,256
1637,161,5561,80,199,3,0,0,282
1638,161,5562,85,179,1,4,0,269
1639,161,5563,67,199,2,4,0,272
1640,161,5564,61,203,2,1,0,267
1641,161,5565,64,185,3,9,0,261
1642,161,5566,83,156,2,0,0,241
1643,161,5567,84,174,4,3,0,265
1644,161,5568,78,179,3,4,0,264
1645,183,5776,108,157,3,3,0,271
1646,183,5777,77,180,9,0,0,266
1647,183,5778,71,203,4,1,0,279
1648,183,5779,83,195,0,2,0,280
1649,183,5780,81,168,4,0,0,253
1650,183,5781,65,191,2,3,0,261
1651,183,5782,72,189,0,2,0,263
1652,183,5783,74,191,6,0,0,271
1653,183,5784,93,159,5,6,0,263
1654,183,5785,84,192,1,2,0,279
1655,183,5786,103,174,1,1,0,279
1656,183,5787,89,167,1,4,0,261
1657,183,5788,89,175,2,4,0,270
1658,183,5789,60,203,1,0,0,264
1659,183,5790,88,184,3,0,0,275
1660,183,5791,86,189,2,1,0,278
1661,183,5792,78,191,1,5,0,275
1662,183,5793,101,161,1,2,0,265
1663,183,5794,86,165,6,0,0,257
1664,183,5795,91,167,7,0,0,265
1665,183,5796,88,181,2,4,0,275
1666,183,5797,91,159,2,2,0,254
1667,183,5798,93,183,0,1,0,277
1668,183,5799,70,204,2,2,0,278
1669,183,5800,104,150,3,0,0,257
1670,183,5801,75,200,0,2,0,277
1671,183,5802,97,170,2,5,0,274
1672,168,5706,57,156,2,0,0,215
1673,168,5707,46,165,0,0,0,211
1674,168,5708,58,168,0,2,0,228
1675,178,5749,14,20,2,0,0,36
1676,169,5709,39,132,0,7,0,178
1677,169,5710,43,126,2,3,0,174
1678,184,5803,91,166,2,3,0,262
1679,184,5804,107,149,5,2,0,263
1680,184,5805,94,179,0,6,3,282
1681,184,5806,51,233,6,0,0,290
1682,184,5807,72,192,2,5,0,271
1683,184,5808,87,188,3,0,0,278
1684,184,5809,78,196,1,1,0,276
1685,184,5810,96,159,3,6,0,264
1686,184,5811,75,195,6,0,0,276
1687,184,5812,90,168,2,7,0,267
1688,184,5813,67,196,1,2,0,266
1689,184,5814,81,181,3,3,0,268
1690,184,5815,100,169,1,1,0,271
1691,184,5816,84,183,5,8,0,280
1692,184,5817,74,202,3,1,0,280
1693,184,5818,59,202,1,3,0,265
1694,184,5819,85,196,6,0,0,287
1695,184,5820,74,182,3,2,0,261
1696,184,5821,85,183,0,3,0,271
1697,184,5822,90,178,3,0,0,271
1698,184,5823,76,189,3,2,0,270
1699,184,5824,85,176,4,1,0,266
1700,184,5825,77,198,3,3,0,281
1701,184,5826,96,159,3,17,0,275
1702,182,5773,25,220,2,1,0,248
1703,182,5774,47,212,2,2,0,263
1704,182,5775,41,208,2,2,0,253
1705,162,5569,90,153,5,1,0,249
1706,162,5570,66,214,4,3,0,287
1707,162,5571,36,232,4,0,0,272
1708,162,5572,69,202,1,1,0,273
1709,162,5573,57,196,1,4,0,258
1710,162,5574,87,200,3,2,0,292
1711,162,5575,75,210,1,4,0,290
1712,162,5576,74,206,2,2,0,284
1713,162,5577,92,176,4,2,0,274
1714,162,5578,78,197,4,5,0,284
1715,162,5579,91,189,7,5,0,292
1716,162,5580,98,170,2,3,0,273
1717,162,5581,75,195,10,0,0,280
1718,162,5582,85,189,2,3,0,279
1719,162,5583,79,209,1,3,0,292
1720,162,5584,77,186,3,4,0,270
1721,018B,3218,74,90,1,2,0,167
1722,020B,3256,99,128,3,7,0,237
1723,020B,3257,99,118,1,7,0,225
1724,020B,3258,79,145,1,4,0,229
1725,020B,3259,96,130,2,4,0,232
1726,025B,3298,69,179,1,5,0,254
1727,17,3191,120,153,0,8,0,281
1728,17,3192,92,172,1,5,0,270
1729,17,3193,107,146,4,3,0,260
1730,17,3194,120,151,0,2,0,273
1731,17,3195,109,157,8,2,0,276
1732,17,3196,112,159,2,4,0,277
1733,17,3197,123,158,2,5,2,290
1734,17,3198,113,156,1,15,0,285
1735,17,3199,110,165,3,7,0,285
1736,17,3200,106,152,0,10,0,268
1737,17,3201,114,151,5,4,0,274
1738,17,3202,116,166,14,0,0,296
1739,17,3203,111,150,1,8,0,270
1740,17,3204,112,147,2,7,0,268
1741,17,3205,121,158,3,3,0,285
1742,17,3206,92,180,3,4,0,279
1743,17,3207,116,158,1,3,0,278
1744,17,3208,98,177,1,9,0,285
1745,17,3209,91,186,5,5,0,287
1746,17,3210,122,152,1,5,0,280
1747,17,3211,117,155,2,4,0,278
1748,328A,3335,57,124,3,1,0,185
1749,328A,3336,76,136,2,5,0,219
1750,328A,3337,74,121,2,6,0,203
1751,15,3184,88,110,0,1,0,199
1752,24,3270,83,139,3,4,0,229
1753,24,3271,89,137,6,14,0,246
1754,24,3272,85,157,2,4,0,248
1755,24,3273,86,149,3,7,0,245
1756,24,3274,98,150,2,6,0,256
1757,24,3275,89,155,3,4,0,251
1758,24,3276,67,176,2,3,0,248
1759,24,3277,86,155,2,1,0,244
1760,026B,3334,41,65,1,1,0,108
1761,19,3221,71,185,3,8,0,267
1762,19,3222,50,205,1,5,0,261
1763,19,3223,58,183,2,8,0,251
1764,19,3224,49,195,3,7,0,254
1765,19,3225,63,192,1,6,0,262
1766,19,3226,66,184,8,0,0,258
1767,19,3227,62,178,9,0,0,249
1768,19,3228,60,190,5,7,0,262
1769,19,3229,48,196,10,0,0,254
1770,18,3212,64,169,2,2,8,245
1771,18,3213,63,183,0,3,0,249
1772,18,3214,73,162,2,0,0,237
1773,18,3215,71,171,0,2,0,244
1774,18,3216,84,161,2,3,0,250
1775,015A,3185,91,121,0,2,0,214
1776,015A,3186,81,120,2,2,0,205
1777,16,3187,25,64,2,3,0,94
1778,23,3265,103,118,3,1,0,225
1779,23,3266,113,104,3,4,0,224
1780,23,3267,118,114,3,4,0,239
1781,23,3268,111,106,4,4,0,225
1782,23,3269,111,114,3,3,0,231
1783,20,3230,102,177,7,3,0,289
1784,20,3231,98,167,0,5,0,270
1785,20,3232,116,155,4,4,0,279
1786,20,3233,107,166,3,7,0,283
1787,026A,3333,61,47,0,2,0,110
1788,22,3261,60,153,3,0,0,216
1789,22,3262,78,141,4,0,0,223
1790,22,3263,70,138,0,2,0,210
1791,22,3264,61,151,0,6,0,218
1792,016C,3190,24,63,1,1,0,89
1793,018C,3219,13,41,0,0,0,54
1794,025A,3297,26,80,0,2,0,108
1795,018A,3217,22,71,2,2,0,97
1796,016A,3188,7,25,0,0,0,32
1797,26,3299,89,169,3,2,0,263
1798,26,3300,73,191,3,5,0,272
1799,26,3301,72,191,0,3,0,266
1800,26,3302,90,180,3,5,0,278
1801,26,3303,67,206,6,0,4,283
1802,26,3304,73,175,4,3,0,255
1803,26,3305,78,193,0,5,0,276
1804,26,3306,70,200,1,2,0,273
1805,26,3307,88,195,3,4,0,290
1806,26,3308,83,190,2,2,0,277
1807,26,3309,81,199,1,9,0,290
1808,26,3310,56,187,1,3,0,247
1809,26,3311,62,210,2,1,0,275
1810,26,3312,101,161,3,4,0,269
1811,26,3313,94,168,5,7,0,274
1812,26,3314,73,198,5,1,0,277
1813,26,3315,97,166,3,3,0,269
1814,26,3316,80,191,2,4,0,277
1815,26,3317,92,176,2,4,0,274
1816,26,3318,60,198,1,3,0,262
1817,26,3319,94,160,8,0,0,262
1818,26,3320,92,175,2,4,0,273
1819,26,3321,90,190,2,2,0,284
1820,26,3322,97,186,1,1,0,285
1821,26,3323,80,197,1,4,0,282
1822,26,3324,71,199,3,3,0,276
1823,26,3325,96,175,0,4,0,275
1824,26,3326,105,156,0,3,0,264
1825,26,3327,84,171,3,3,0,261
1826,26,3328,68,188,4,4,0,264
1827,26,3329,78,187,0,7,0,272
1828,26,3330,76,185,1,4,0,266
1829,26,3331,104,168,0,4,6,282
1830,26,3332,98,159,2,5,0,264
1831,25,3288,75,207,2,1,0,285
1832,25,3289,50,234,3,7,0,294
1833,25,3290,51,243,4,0,0,298
1834,25,3291,63,216,2,0,0,281
1835,25,3292,64,210,3,0,0,277
1836,25,3293,57,230,2,0,0,289
1837,25,3294,84,172,0,7,0,263
1838,25,3295,39,237,4,0,0,280
1839,25,3296,75,199,10,0,0,284
1840,020A,3234,86,173,2,6,0,267
1841,020A,3235,68,199,3,3,0,273
1842,020A,3236,59,190,4,5,0,258
1843,020A,3237,68,197,4,2,0,271
1844,020A,3238,76,189,4,8,0,277
1845,020A,3239,58,212,2,4,0,276
1846,020A,3240,62,209,4,6,0,281
1847,020A,3241,70,193,7,8,0,278
1848,020A,3242,73,189,5,3,0,270
1849,020A,3243,50,213,5,7,0,275
1850,020A,3244,50,213,4,9,0,276
1851,020A,3245,47,212,2,6,0,267
1852,020A,3246,62,191,3,8,0,264
1853,020A,3247,79,186,3,5,0,273
1854,020A,3248,89,181,2,9,0,281
1855,020A,3249,76,188,1,9,0,274
1856,020A,3250,68,211,3,5,0,287
1857,020A,3251,64,196,3,7,0,270
1858,020A,3252,58,220,1,5,0,284
1859,020A,3253,64,207,4,4,0,279
1860,020A,3254,64,190,2,7,0,263
1861,020A,3255,65,202,0,9,0,276
1862,024A,3278,102,153,2,8,0,265
1863,024A,3279,102,143,0,9,0,254
1864,024A,3280,89,174,8,0,0,271
1865,024A,3281,91,165,3,9,0,268
1866,024A,3282,99,162,1,5,0,267
1867,024A,3283,95,161,4,0,0,260
1868,024A,3284,113,143,2,3,0,261
1869,024A,3285,100,160,0,6,0,266
1870,024A,3286,106,162,7,0,0,275
1871,024A,3287,124,146,2,4,0,276
1872,016B,3189,4,4,0,0,0,8
1873,21,3260,26,178,3,0,0,207
1874,018D,3220,32,90,2,1,0,125
1875,92,4525,47,100,1,3,0,151
1876,92,4526,43,100,1,3,0,147
1877,97,4587,12,33,0,0,0,45
1878,101,4605,18,40,0,0,0,58
1879,091A,4522,8,5,0,0,0,13
1880,096A,4585,171,48,1,2,0,222
1881,096A,4586,160,52,0,2,0,214
1882,91,4520,75,128,0,1,0,204
1883,91,4521,98,97,1,0,0,196
1884,98,4588,23,19,2,0,0,44
1885,091B,4523,25,62,1,0,0,88
1886,99,4589,116,125,6,2,0,249
1887,99,4590,80,164,3,1,0,248
1888,99,4591,92,151,2,2,0,247
1889,99,4592,89,159,0,2,0,250
1890,99,4593,65,160,1,5,0,231
1891,99,4594,90,149,4,4,0,247
1892,99,4595,83,152,0,3,0,238
1893,99,4596,78,160,2,4,0,244
1894,99,4597,92,135,3,0,0,230
1895,99,4598,92,143,4,3,0,242
1896,99,4599,94,128,3,2,0,227
1897,99,4600,89,136,1,0,0,226
1898,99,4601,94,131,4,4,0,233
1899,93,4527,66,62,0,1,0,129
1900,93,4528,70,55,0,1,0,126
1901,95,4531,106,153,3,4,0,266
1902,95,4532,88,171,1,2,0,262
1903,95,4533,90,166,2,2,0,260
1904,95,4534,105,160,2,5,0,272
1905,95,4535,82,155,4,3,0,244
1906,95,4536,88,184,2,3,0,277
1907,95,4537,101,166,1,2,0,270
1908,95,4538,74,196,2,6,0,278
1909,95,4539,89,188,2,1,0,280
1910,95,4540,95,180,3,1,0,279
1911,95,4541,99,159,1,3,0,262
1912,95,4542,90,172,1,3,0,266
1913,95,4543,96,165,1,3,0,265
1914,95,4544,76,201,2,3,0,282
1915,95,4545,77,198,2,8,0,285
1916,95,4546,107,157,1,7,0,272
1917,95,4547,92,162,0,6,0,260
1918,95,4548,89,182,2,1,0,274
1919,95,4549,109,173,5,0,0,287
1920,95,4550,101,160,4,2,23,290
1921,95,4551,94,171,5,4,0,274
1922,95,4552,81,180,2,2,0,265
1923,95,4553,79,187,2,0,0,268
1924,95,4554,95,165,4,2,0,266
1925,95,4555,88,190,4,4,0,286
1926,95,4556,73,188,1,2,0,264
1927,95,4557,95,162,13,3,0,273
1928,95,4558,94,162,0,7,0,263
1929,95,4559,81,193,2,3,0,279
1930,95,4560,110,143,1,1,0,255
1931,95,4561,84,183,1,3,0,271
1932,95,4562,90,178,7,3,0,278
1933,95,4563,114,133,4,5,0,256
1934,95,4564,85,177,4,5,0,271
1935,95,4565,84,153,3,7,0,247
1936,95,4566,107,160,2,1,0,270
1937,95,4567,101,160,3,2,0,266
1938,95,4568,98,177,1,6,0,282
1939,95,4569,93,163,4,0,0,260
1940,95,4570,116,152,3,1,0,272
1941,95,4571,98,155,2,3,0,258
1942,95,4572,81,184,2,1,0,268
1943,95,4573,120,154,0,0,0,274
1944,95,4574,105,165,3,2,0,275
1945,95,4575,95,181,2,0,0,278
1946,95,4576,80,198,2,2,0,282
1947,95,4577,91,183,3,1,0,278
1948,95,4578,114,144,4,2,0,264
1949,95,4579,81,172,5,9,0,267
1950,95,4580,85,175,3,6,0,269
1951,95,4581,122,142,2,1,0,267
1952,95,4582,111,150,3,6,0,270
1953,95,4583,105,169,3,5,0,282
1954,95,4584,99,176,0,1,0,276
1955,94,4529,145,85,0,0,0,230
1956,94,4530,160,77,1,0,0,238
1957,091C,4524,120,120,0,0,0,240
1958,100,4602,126,122,0,2,0,250
1959,100,4603,108,140,2,3,0,253
1960,100,4604,109,127,1,1,0,238
1961,339,7798,94,146,0,1,0,241
1962,339,7799,98,126,5,0,0,229
1963,339,7800,102,125,10,0,0,237
1964,339,7801,88,157,5,0,0,250
1965,339,7802,102,126,3,2,0,233
1966,347A,7901,52,180,0,0,0,232
1967,347,7900,51,140,0,1,0,192
1968,336,7754,93,184,1,4,0,282
1969,336,7755,77,201,1,7,0,286
1970,336,7756,87,172,2,8,0,269
1971,336,7757,79,199,5,5,0,288
1972,336,7758,89,185,1,3,0,278
1973,336,7759,88,186,3,2,0,279
1974,336,7760,75,197,2,2,0,276
1975,336,7761,91,196,0,3,0,290
1976,336,7762,76,190,12,0,0,278
1977,336,7763,89,184,3,1,0,277
1978,336,7764,82,204,1,4,0,291
1979,336,7765,93,173,5,0,0,271
1980,336,7766,91,185,0,5,0,281
1981,336,7767,113,174,1,5,0,293
1982,336,7768,100,164,1,4,0,269
1983,336,7769,94,182,4,3,0,283
1984,336,7770,67,206,4,2,0,279
1985,336,7771,63,225,0,5,0,293
1986,336,7772,85,191,3,3,0,282
1987,336,7773,92,195,1,5,0,293
1988,336,7774,90,195,0,2,0,287
1989,336,7775,86,203,3,1,0,293
1990,336,7776,92,186,4,2,0,284
1991,336,7777,88,195,3,0,0,286
1992,336,7778,88,163,4,3,0,258
1993,336,7779,66,197,2,7,0,272
1994,336,7780,80,196,1,2,0,279
1995,336,7781,80,194,0,0,0,274
1996,336,7782,105,166,7,0,0,278
1997,336,7783,86,204,0,7,0,297
1998,341,7832,77,185,2,1,0,265
1999,341,7833,64,202,0,1,0,267
2000,341,7834,77,187,1,1,0,266
2001,341,7835,65,197,0,5,0,267
2002,341,7836,67,201,3,2,0,273
2003,341,7837,59,205,1,5,0,270
2004,341,7838,76,182,3,7,0,268
2005,341,7839,56,205,0,5,0,266
2006,341,7840,82,174,2,9,0,267
2007,341,7841,64,194,1,3,0,262
2008,341,7842,59,194,2,5,0,260
2009,341,7843,53,201,1,4,0,259
2010,341,7844,78,169,3,8,0,258
2011,341,7845,62,189,3,9,0,263
2012,343,7859,25,220,2,0,0,247
2013,343,7860,43,206,1,1,0,251
2014,348,7902,87,173,2,3,0,265
2015,348,7903,87,194,3,4,0,288
2016,348,7904,103,173,1,1,0,278
2017,348,7905,72,191,3,5,0,271
2018,348,7906,85,182,3,0,0,270
2019,348,7907,133,151,1,3,0,288
2020,348,7908,88,187,2,3,0,280
2021,348,7909,93,189,5,5,0,292
2022,348,7910,74,192,9,0,0,275
2023,348,7911,70,194,3,5,0,272
2024,348,7912,83,191,2,3,0,279
2025,348,7913,103,182,3,8,0,296
2026,348,7914,74,206,2,3,0,285
2027,348,7915,46,225,4,6,0,281
2028,348,7916,63,192,2,4,0,261
2029,348,7917,69,215,5,1,0,290
2030,348,7918,72,204,2,0,0,278
2031,348,7919,72,223,1,1,0,297
2032,348,7920,96,169,0,3,0,268
2033,348,7921,93,186,0,2,0,281
2034,348,7922,81,199,2,5,0,287
2035,348,7923,90,190,1,2,0,283
2036,348,7924,82,183,2,5,0,272
2037,348,7925,98,165,4,0,0,267
2038,348,7926,94,180,0,10,0,284
2039,348,7927,68,204,2,4,0,278
2040,348,7928,79,205,3,2,0,289
2041,348,7929,77,197,2,1,0,277
2042,348,7930,91,200,7,0,0,298
2043,348,7931,92,186,3,3,0,284
2044,348,7932,88,182,4,5,0,279
2045,348,7933,78,191,2,0,0,271
2046,348,7934,83,189,4,2,0,278
2047,348,7935,61,206,4,8,0,279
2048,348,7936,79,183,4,0,0,266
2049,348,7937,124,143,2,5,0,274
2050,348,7938,59,220,1,2,0,282
2051,348,7939,95,172,1,2,0,270
2052,348,7940,87,179,3,2,0,271
2053,348,7941,86,184,3,9,0,282
2054,348,7942,98,168,5,2,0,273
2055,348,7943,85,186,2,5,0,278
2056,348,7944,74,186,4,5,0,269
2057,348,7945,108,169,3,3,0,283
2058,348,7946,74,198,3,2,0,277
2059,348,7947,92,191,4,5,0,292
2060,348,7948,100,166,2,7,0,275
2061,348,7949,62,200,1,5,0,268
2062,348,7950,70,202,2,4,0,278
2063,348,7951,77,189,3,7,0,276
2064,348,7952,52,233,2,0,0,287
2065,348,7953,97,178,0,4,1,280
2066,348,7954,109,165,4,2,0,280
2067,348,7955,99,167,6,8,0,280
2068,348,7956,86,183,1,12,0,282
2069,348,7957,56,241,1,2,0,300
2070,348,7958,94,163,3,4,0,264
2071,348,7959,86,187,4,8,0,285
2072,348,7960,72,205,6,3,0,286
2073,348,7961,101,160,5,4,0,270
2074,348,7962,92,174,1,4,0,271
2075,348,7963,79,188,4,6,0,277
2076,348,7964,95,168,1,9,0,273
2077,348,7965,90,189,4,1,0,284
2078,348,7966,85,179,5,2,0,271
2079,348,7967,77,204,3,6,0,290
2080,348,7968,86,195,5,6,0,292
2081,348,7969,73,189,3,6,0,271
2082,348,7970,76,197,2,2,0,277
2083,348,7971,79,197,2,7,0,285
2084,348,7972,90,172,5,6,0,273
2085,348,7973,94,169,1,7,0,271
2086,348,7974,95,200,2,5,0,302
2087,348,7975,88,176,1,3,0,268
2088,348,7976,75,187,10,0,0,272
2089,348,7977,76,195,3,3,0,277
2090,348,7978,87,186,2,0,0,275
2091,348,7979,100,169,5,2,0,276
2092,348,7980,68,186,3,6,0,263
2093,348,7981,94,180,1,6,0,281
2094,348,7982,83,190,3,0,0,276
2095,348,7983,101,168,5,5,0,279
2096,348,7984,88,179,1,4,0,272
2097,348,7985,92,192,1,4,0,289
2098,348,7986,88,186,2,5,0,281
2099,348,7987,78,203,3,4,0,288
2100,348,7988,72,200,1,2,0,275
2101,348,7989,80,183,4,3,0,270
2102,348,7990,81,182,5,5,0,273
2103,348,7991,70,186,0,4,0,260
2104,348,7992,64,209,3,2,0,278
2105,348,7993,71,202,2,3,0,278
2106,348,7994,72,199,2,4,0,277
2107,348,7995,71,206,5,4,0,286
2108,348,7996,124,159,1,2,0,286
2109,348,7997,89,191,2,2,0,284
2110,348,7998,82,196,2,3,0,283
2111,348,7999,82,188,6,3,0,279
2112,348,8000,92,191,2,5,0,290
2113,348,8001,91,185,2,3,0,281
2114,348,8002,89,180,1,2,0,272
2115,348,8003,112,165,1,8,0,286
2116,348,8004,76,206,2,3,0,287
2117,348,8005,87,188,1,2,0,278
2118,348,8006,92,173,2,2,0,269
2119,348,8007,64,207,1,3,0,275
2120,348,8008,68,181,9,9,0,267
2121,348,8009,67,196,9,5,0,277
2122,348,8010,74,210,1,5,0,290
2123,348,8011,77,199,5,5,0,286
2124,348,8012,78,180,1,6,0,265
2125,348,8013,73,202,5,5,0,285
2126,348,8014,76,189,3,2,0,270
2127,348,8015,94,193,3,3,0,293
2128,348,8016,80,197,4,3,0,284
2129,348,8017,95,181,1,3,0,280
2130,348,8018,89,200,3,2,0,294
2131,348,8019,101,174,4,0,0,279
2132,348,8020,97,185,6,6,0,294
2133,348,8021,89,184,4,7,0,284
2134,348,8022,84,186,1,5,0,276
2135,348,8023,80,200,2,9,0,291
2136,349,8024,77,198,3,3,0,281
2137,349,8025,72,215,4,6,0,297
2138,349,8026,69,194,2,4,0,269
2139,349,8027,57,222,3,3,0,285
2140,349,8028,67,215,3,1,0,286
2141,349,8029,57,222,3,5,0,287
2142,349,8030,64,212,3,2,0,281
2143,349,8031,69,190,14,0,0,273
2144,349,8032,73,199,6,0,0,278
2145,349,8033,77,180,5,2,0,264
2146,349,8034,57,225,0,3,0,285
2147,349,8035,81,199,2,6,0,288
2148,349,8036,74,201,6,0,0,281
2149,349,8037,71,207,4,0,0,282
2150,342,7846,72,193,16,0,0,281
2151,342,7847,56,195,2,4,0,257
2152,342,7848,59,188,12,0,0,259
2153,342,7849,64,190,1,9,0,264
2154,342,7850,66,194,12,0,0,272
2155,342,7851,80,185,2,5,0,272
2156,342,7852,67,181,8,11,0,267
2157,342,7853,68,184,1,8,0,261
2158,342,7854,79,175,7,0,0,261
2159,342,7855,53,203,2,6,0,264
2160,342,7856,81,174,2,6,0,263
2161,342,7857,61,192,9,0,0,262
2162,342,7858,71,192,2,3,0,268
2163,337,7784,132,162,4,0,0,298
2164,337,7785,120,172,5,0,0,297
2165,337,7786,113,163,4,0,0,280
2166,337,7787,128,160,2,0,0,290
2167,337,7788,142,142,7,0,0,291
2168,337,7789,115,166,0,0,0,281
2169,337,7790,136,156,3,0,0,295
2170,337A,7791,32,211,0,2,0,245
2171,337A,7792,77,178,1,0,0,256
2172,349A,8038,71,90,0,0,0,161
2173,349A,8039,80,77,1,1,0,159
2174,346,7896,76,184,2,2,0,264
2175,346,7897,58,193,0,5,0,256
2176,346,7898,56,189,0,5,0,250
2177,346,7899,71,190,1,5,0,267
2178,344,7861,50,201,5,1,0,257
2179,344,7862,45,197,6,0,0,248
2180,344,7863,55,211,2,3,0,271
2181,344,7864,47,230,1,3,0,281
2182,344,7865,51,226,4,1,0,282
2183,344,7866,42,221,0,4,0,267
2184,344,7867,62,209,4,1,0,276
2185,344,7868,43,224,2,3,0,272
2186,344,7869,69,201,1,2,0,273
2187,344,7870,38,226,0,3,0,267
2188,344,7871,66,193,2,1,0,262
2189,344,7872,61,190,2,2,0,255
2190,344,7873,51,205,3,2,0,261
2191,344,7874,42,233,1,5,0,281
2192,344,7875,71,171,1,3,0,246
2193,344,7876,54,202,6,2,0,264
2194,344,7877,42,243,1,0,0,286
2195,344,7878,40,224,5,2,0,271
2196,344,7879,47,211,3,3,0,264
2197,344,7880,50,208,6,1,0,265
2198,344,7881,54,184,2,9,0,249
2199,344,7882,48,204,3,4,0,259
2200,344,7883,79,172,1,0,0,252
2201,344,7884,62,191,3,5,0,261
2202,344,7885,53,220,1,2,0,276
2203,344,7886,32,233,4,1,0,270
2204,344,7887,51,189,1,5,0,246
2205,344,7888,60,198,2,6,0,266
2206,344,7889,55,208,2,2,0,267
2207,344,7890,50,198,5,0,0,253
2208,344,7891,60,189,2,5,0,256
2209,344,7892,53,192,2,1,0,248
2210,344,7893,51,206,2,1,0,260
2211,345,7894,39,121,2,0,0,162
2212,345,7895,36,138,7,0,0,181
2213,340,7803,58,207,2,2,0,269
2214,340,7804,53,198,2,3,0,256
2215,340,7805,55,216,1,7,0,279
2216,340,7806,35,241,0,9,0,285
2217,340,7807,44,231,0,7,0,282
2218,340,7808,68,194,3,7,0,272
2219,340,7809,52,227,2,7,0,288
2220,340,7810,57,216,4,0,0,277
2221,340,7811,31,250,5,4,0,290
2222,340,7812,53,219,2,6,0,280
2223,340,7813,61,210,0,7,0,278
2224,340,7814,59,209,2,6,0,276
2225,340,7815,41,229,1,7,0,278
2226,340,7816,41,227,3,3,0,274
2227,340,7817,80,181,2,9,0,272
2228,340,7818,39,216,1,4,0,260
2229,340,7819,53,202,1,2,0,258
2230,340,7820,38,240,2,3,0,283
2231,340,7821,49,206,0,0,0,255
2232,340,7822,57,214,6,0,0,277
2233,340,7823,46,229,1,1,0,277
2234,340,7824,74,179,1,8,0,262
2235,340,7825,48,212,2,1,0,263
2236,340,7826,40,224,1,4,0,269
2237,340,7827,61,192,5,0,0,258
2238,340,7828,39,218,0,7,0,264
2239,340,7829,58,208,4,4,0,274
2240,340,7830,78,187,1,6,0,272
2241,340,7831,62,205,0,4,0,271
2242,338,7793,63,217,6,0,0,286
2243,338,7794,76,204,6,0,0,286
2244,338,7795,56,216,10,0,0,282
2245,338,7796,64,209,0,0,0,273
2246,338,7797,72,198,8,0,0,278
2247,041A,3916,63,214,1,7,0,285
2248,041A,3917,71,186,0,13,0,270
2249,041A,3918,70,198,3,5,0,276
2250,041A,3919,76,179,0,5,0,260
2251,041A,3920,50,206,1,3,0,260
2252,041A,3921,50,209,1,5,0,265
2253,041A,3922,81,175,1,11,0,268
2254,041A,3923,73,191,2,6,0,272
2255,041A,3924,77,196,2,6,0,281
2256,041A,3925,80,192,3,7,0,282
2257,041A,3926,66,203,4,1,0,274
2258,041A,3927,67,198,3,5,0,273
2259,041A,3928,77,189,4,3,0,273
2260,041A,3929,68,185,3,2,0,258
2261,041A,3930,65,199,2,11,0,277
2262,041A,3931,71,188,3,10,0,272
2263,041A,3932,70,192,2,5,0,269
2264,041A,3933,60,191,1,7,0,259
2265,041A,3934,71,191,2,10,0,274
2266,041A,3935,64,188,2,2,0,256
2267,041A,3936,67,190,4,1,0,262
2268,041A,3937,72,202,4,4,0,282
2269,041A,3938,68,203,0,8,0,279
2270,041A,3939,81,169,2,9,0,261
2271,041A,3940,75,193,2,2,0,272
2272,041A,3941,76,189,5,7,0,277
2273,041A,3942,65,189,0,6,0,260
2274,041A,3943,58,200,5,4,0,267
2275,041A,3944,70,186,3,8,1,268
2276,041A,3945,78,182,4,3,0,267
2277,041A,3946,45,208,3,13,0,269
2278,041A,3947,60,204,1,9,0,274
2279,36,3671,46,91,3,1,0,141
2280,36,3672,0,0,0,0,0,0
2281,27,3338,58,195,3,4,0,260
2282,27,3339,64,189,2,4,0,259
2283,27,3340,75,188,5,2,0,270
2284,27,3341,62,176,18,0,0,256
2285,27,3342,60,192,2,4,1,259
2286,27,3343,58,192,0,6,0,256
2287,27,3344,65,186,3,4,0,258
2288,27,3345,65,178,4,9,0,256
2289,27,3346,69,166,5,3,0,243
2290,27,3347,64,184,2,4,0,254
2291,41,3832,58,216,0,3,0,277
2292,41,3833,72,201,4,5,0,282
2293,41,3834,57,214,4,4,0,279
2294,41,3835,78,198,3,2,0,281
2295,41,3836,56,207,2,4,0,269
2296,41,3837,53,224,1,0,2,280
2297,41,3838,49,234,3,2,0,288
2298,41,3839,57,227,3,0,0,287
2299,41,3840,50,225,1,1,0,277
2300,41,3841,64,208,1,1,0,274
2301,41,3842,48,247,1,5,0,301
2302,41,3843,65,221,0,0,0,286
2303,41,3844,48,233,2,2,0,285
2304,41,3845,44,238,4,0,0,286
2305,41,3846,57,227,4,0,0,288
2306,41,3847,81,195,4,5,0,285
2307,41,3848,85,197,2,3,0,287
2308,41,3849,50,222,1,2,0,275
2309,41,3850,63,229,6,4,0,302
2310,41,3851,47,226,3,3,0,279
2311,41,3852,78,195,3,6,0,282
2312,41,3853,61,222,4,3,0,290
2313,41,3854,57,234,2,4,0,297
2314,41,3855,79,205,5,4,0,293
2315,41,3856,67,215,3,2,0,287
2316,41,3857,64,223,4,4,0,295
2317,41,3858,73,219,2,2,0,296
2318,41,3859,70,211,3,6,0,290
2319,41,3860,65,200,2,4,0,271
2320,41,3861,68,213,2,4,0,287
2321,41,3862,62,230,1,2,1,296
2322,41,3863,58,221,4,4,0,287
2323,41,3864,45,234,3,2,0,284
2324,41,3865,63,215,4,1,0,283
2325,41,3866,66,210,3,0,0,279
2326,41,3867,72,212,1,4,0,289
2327,41,3868,54,211,4,2,0,271
2328,41,3869,57,205,6,4,0,272
2329,41,3870,50,230,6,0,0,286
2330,41,3871,57,224,3,3,0,287
2331,41,3872,47,236,2,7,0,292
2332,41,3873,62,202,5,5,0,274
2333,41,3874,56,235,3,2,0,296
2334,41,3875,33,239,9,4,0,285
2335,41,3876,85,182,1,3,0,271
2336,41,3877,62,210,1,3,0,276
2337,41,3878,48,216,7,5,0,276
2338,41,3879,50,219,1,1,0,271
2339,41,3880,45,239,2,0,0,286
2340,41,3881,51,233,6,1,0,291
2341,41,3882,67,207,1,2,0,277
2342,41,3883,62,213,4,6,1,286
2343,41,3884,67,201,3,5,0,276
2344,41,3885,88,179,1,3,0,271
2345,41,3886,64,211,3,4,0,282
2346,41,3887,60,221,3,2,0,286
2347,41,3888,58,215,1,0,0,274
2348,41,3889,56,221,2,0,0,279
2349,41,3890,84,196,4,3,0,287
2350,41,3891,57,227,1,4,0,289
2351,41,3892,61,198,3,3,0,265
2352,41,3893,70,214,0,3,0,287
2353,41,3894,60,227,7,1,0,295
2354,41,3895,53,208,3,5,0,269
2355,41,3896,55,213,5,6,0,279
2356,41,3897,74,198,2,4,0,278
2357,41,3898,60,214,2,3,0,279
2358,41,3899,60,204,3,3,0,270
2359,41,3900,70,194,3,3,0,270
2360,41,3901,51,217,6,3,0,277
2361,41,3902,57,234,2,2,0,295
2362,41,3903,63,213,2,3,0,281
2363,41,3904,53,213,3,5,0,274
2364,41,3905,70,227,1,1,0,299
2365,41,3906,51,237,1,0,0,289
2366,41,3907,48,219,2,2,0,271
2367,41,3908,84,178,2,3,0,267
2368,41,3909,60,204,1,1,0,266
2369,41,3910,75,206,1,3,0,285
2370,41,3911,55,220,2,4,0,281
2371,41,3912,61,203,3,3,0,270
2372,41,3913,67,207,1,1,0,276
2373,41,3914,47,244,2,3,0,296
2374,41,3915,69,218,1,0,0,288
2375,029A,3484,92,134,0,2,0,228
2376,29,3435,46,219,1,5,2,273
2377,29,3436,39,232,0,3,0,274
2378,29,3437,34,251,2,4,0,291
2379,29,3438,42,236,2,2,0,282
2380,29,3439,55,208,5,4,1,273
2381,29,3440,27,247,1,4,0,279
2382,29,3441,48,245,2,2,0,297
2383,29,3442,52,219,3,2,0,276
2384,29,3443,36,243,0,1,0,280
2385,29,3444,37,239,2,5,0,283
2386,29,3445,51,223,1,2,0,277
2387,29,3446,63,223,2,4,0,292
2388,29,3447,48,229,3,1,0,281
2389,29,3448,42,227,0,4,0,273
2390,29,3449,41,241,4,0,0,286
2391,29,3450,43,233,3,1,0,280
2392,29,3451,36,230,2,7,0,275
2393,29,3452,56,208,4,2,0,270
2394,29,3453,48,233,1,0,0,282
2395,29,3454,39,234,1,5,0,279
2396,29,3455,47,212,0,6,0,265
2397,29,3456,27,255,1,3,0,286
2398,29,3457,57,218,2,4,0,281
2399,29,3458,43,240,1,6,0,290
2400,29,3459,28,252,4,1,0,285
2401,29,3460,40,234,1,2,0,277
2402,29,3461,62,205,0,11,0,278
2403,29,3462,45,231,0,8,0,284
2404,29,3463,41,241,2,1,0,285
2405,29,3464,40,218,3,5,0,266
2406,29,3465,33,231,4,5,0,273
2407,29,3466,34,251,1,0,0,286
2408,29,3467,42,224,2,7,0,275
2409,29,3468,49,226,1,4,2,282
2410,29,3469,63,212,1,3,0,279
2411,29,3470,47,232,0,8,0,287
2412,29,3471,39,232,0,8,0,279
2413,29,3472,38,228,0,6,0,272
2414,29,3473,72,206,1,5,0,284
2415,29,3474,60,229,2,5,0,296
2416,29,3475,47,232,5,7,0,291
2417,29,3476,46,233,0,5,0,284
2418,29,3477,40,233,2,2,0,277
2419,29,3478,47,222,4,5,0,278
2420,29,3479,48,227,2,5,0,282
2421,29,3480,38,221,2,12,0,273
2422,29,3481,55,213,0,4,0,272
2423,29,3482,39,224,1,3,0,267
2424,29,3483,36,241,1,7,0,285
2425,028A,3399,50,210,4,2,1,267
2426,028A,3400,68,196,5,7,0,276
2427,028A,3401,68,212,1,8,0,289
2428,028A,3402,75,183,1,6,0,265
2429,028A,3403,44,253,3,2,0,302
2430,028A,3404,56,210,5,10,0,281
2431,028A,3405,60,223,0,5,0,288
2432,028A,3406,73,190,12,0,0,275
2433,028A,3407,55,211,5,11,0,282
2434,028A,3408,64,202,3,1,0,270
2435,028A,3409,49,212,3,11,0,275
2436,028A,3410,65,209,6,3,0,283
2437,028A,3411,49,232,7,3,1,292
2438,028A,3412,70,200,3,8,0,281
2439,028A,3413,72,200,6,7,1,286
2440,028A,3414,57,205,2,8,0,272
2441,028A,3415,79,197,2,5,0,283
2442,028A,3416,63,220,4,8,0,295
2443,028A,3417,65,212,2,1,0,280
2444,028A,3418,60,225,1,9,0,295
2445,028A,3419,70,194,3,11,4,282
2446,028A,3420,67,213,4,5,0,289
2447,028A,3421,49,235,1,3,0,288
2448,028A,3422,72,202,1,1,0,276
2449,028A,3423,69,197,2,4,1,273
2450,028A,3424,88,189,1,4,0,282
2451,028A,3425,62,222,5,4,0,293
2452,028A,3426,56,218,2,4,0,280
2453,028A,3427,65,215,1,4,0,285
2454,028A,3428,61,216,9,0,0,286
2455,028A,3429,53,216,0,3,0,272
2456,028A,3430,58,216,0,7,0,281
2457,028A,3431,59,198,1,6,0,264
2458,028A,3432,58,198,1,5,0,262
2459,028A,3433,67,201,1,6,0,275
2460,028A,3434,67,212,3,2,0,284
2461,031A,3505,86,185,0,4,0,275
2462,031A,3506,85,177,2,3,0,267
2463,031A,3507,85,176,4,4,0,269
2464,031A,3508,80,163,5,5,0,253
2465,031A,3509,79,176,3,2,0,260
2466,031A,3510,80,179,2,6,0,267
2467,031A,3511,77,178,5,5,0,265
2468,32,3514,59,191,1,1,0,252
2469,32,3515,69,199,0,1,0,269
2470,32,3516,62,174,0,1,0,237
2471,32,3517,58,182,2,2,0,244
2472,32,3518,71,179,1,8,0,259
2473,32,3519,52,188,5,5,0,250
2474,31,3501,78,133,1,2,0,214
2475,31,3502,97,111,0,1,0,209
2476,31,3503,107,113,4,0,0,224
2477,31,3504,97,120,0,10,0,227
2478,031B,3512,66,76,5,2,0,149
2479,031B,3513,64,87,3,2,0,156
2480,37,3673,56,197,1,6,0,260
2481,37,3674,60,191,5,9,0,265
2482,37,3675,79,184,1,0,2,266
2483,37,3676,55,210,1,11,2,279
2484,37,3677,61,206,5,6,0,278
2485,37,3678,53,182,0,8,0,243
2486,37,3679,61,210,3,6,0,280
2487,37,3680,70,184,3,3,0,260
2488,37,3681,54,202,3,3,0,262
2489,37,3682,62,202,3,6,0,273
2490,37,3683,53,201,2,2,0,258
2491,37,3684,61,195,5,9,0,270
2492,37,3685,55,207,3,1,0,266
2493,37,3686,81,192,0,7,1,281
2494,37,3687,72,204,4,3,0,283
2495,37,3688,71,193,3,4,0,271
2496,37,3689,71,175,4,7,5,262
2497,37,3690,75,181,2,5,0,263
2498,37,3691,75,187,2,4,1,269
2499,37,3692,65,199,8,6,0,278
2500,37,3693,74,193,7,5,0,279
2501,37,3694,59,206,5,8,0,278
2502,37,3695,78,175,6,8,0,267
2503,37,3696,57,214,4,5,0,280
2504,37,3697,78,165,2,7,0,252
2505,37,3698,77,187,6,2,0,272
2506,37,3699,57,216,3,5,1,282
2507,37,3700,60,202,0,7,0,269
2508,37,3701,73,192,2,7,0,274
2509,37,3702,74,196,7,10,0,287
2510,37,3703,62,198,5,7,0,272
2511,37,3704,71,195,2,4,0,272
2512,37,3705,84,181,5,7,0,277
2513,37,3706,66,198,5,5,0,274
2514,37,3707,55,192,2,6,0,255
2515,37,3708,70,201,2,4,0,277
2516,37,3709,44,222,2,3,0,271
2517,37,3710,85,191,3,8,0,287
2518,37,3711,72,181,8,1,0,262
2519,37,3712,73,166,1,3,0,243
2520,37,3713,58,192,4,5,0,259
2521,37,3714,60,205,4,6,0,275
2522,37,3715,71,196,5,7,0,279
2523,37,3716,65,196,2,7,0,270
2524,37,3717,86,174,1,1,0,262
2525,37,3718,65,195,5,4,0,269
2526,37,3719,69,184,0,3,0,256
2527,37,3720,76,190,3,5,0,274
2528,37,3721,79,173,4,8,1,265
2529,37,3722,44,219,1,5,0,269
2530,37,3723,62,201,5,8,0,276
2531,37,3724,54,186,5,12,0,257
2532,37,3725,75,190,5,2,0,272
2533,37,3726,53,203,2,3,1,262
2534,40,3754,90,176,3,3,0,272
2535,40,3755,71,184,2,7,0,264
2536,40,3756,78,191,3,4,0,276
2537,40,3757,77,180,4,6,0,267
2538,40,3758,92,187,1,10,0,290
2539,40,3759,77,194,3,1,0,275
2540,40,3760,84,203,2,10,0,299
2541,40,3761,61,197,3,9,1,271
2542,40,3762,65,197,1,6,0,269
2543,40,3763,84,189,3,5,0,281
2544,40,3764,70,193,7,4,0,274
2545,40,3765,59,191,0,0,0,250
2546,40,3766,79,184,1,9,0,273
2547,40,3767,78,198,4,4,0,284
2548,40,3768,77,193,3,7,0,280
2549,40,3769,69,196,2,6,0,273
2550,40,3770,65,193,5,12,0,275
2551,40,3771,64,203,1,10,0,278
2552,40,3772,64,199,1,11,0,275
2553,40,3773,85,180,3,2,0,270
2554,40,3774,77,182,3,6,0,268
2555,40,3775,78,184,2,10,0,274
2556,40,3776,70,181,5,8,0,264
2557,40,3777,69,204,2,6,0,281
2558,40,3778,70,191,7,10,0,278
2559,40,3779,69,203,1,5,0,278
2560,40,3780,84,181,2,4,0,271
2561,40,3781,74,208,1,5,0,288
2562,40,3782,72,195,1,4,0,272
2563,40,3783,81,201,1,6,0,289
2564,40,3784,108,169,0,7,0,284
2565,40,3785,81,198,3,4,0,286
2566,40,3786,73,195,2,8,0,278
2567,40,3787,93,173,3,5,0,274
2568,40,3788,80,192,2,9,0,283
2569,40,3789,66,200,2,2,0,270
2570,40,3790,70,206,0,6,0,282
2571,40,3791,75,201,1,6,0,283
2572,40,3792,73,176,3,7,0,259
2573,40,3793,73,184,2,3,1,263
2574,40,3794,57,197,1,6,0,261
2575,40,3795,66,183,2,8,0,259
2576,40,3796,89,176,1,5,0,271
2577,40,3797,88,180,3,3,0,274
2578,40,3798,73,184,3,4,0,264
2579,40,3799,81,181,2,3,0,267
2580,40,3800,70,195,0,10,0,275
2581,40,3801,78,175,2,5,0,260
2582,40,3802,77,180,1,3,0,261
2583,35,3633,73,166,0,7,0,246
2584,35,3634,85,183,0,5,0,273
2585,35,3635,74,195,2,7,0,278
2586,35,3636,66,199,3,9,0,277
2587,35,3637,56,191,1,6,0,254
2588,35,3638,67,183,2,2,0,254
2589,35,3639,65,185,0,12,0,262
2590,35,3640,79,187,1,7,0,274
2591,35,3641,73,187,0,6,0,266
2592,35,3642,69,191,8,0,0,268
2593,35,3643,61,193,2,6,0,262
2594,35,3644,80,181,0,2,0,263
2595,35,3645,76,178,0,4,0,258
2596,35,3646,62,214,0,6,0,282
2597,35,3647,66,196,4,7,0,273
2598,35,3648,59,221,2,5,0,287
2599,35,3649,70,197,2,5,0,274
2600,35,3650,60,208,2,6,0,276
2601,35,3651,79,199,0,2,0,280
2602,35,3652,61,212,3,4,0,280
2603,35,3653,76,182,2,14,0,274
2604,35,3654,79,194,0,10,0,283
2605,35,3655,79,175,3,7,0,264
2606,35,3656,75,179,0,5,0,259
2607,35,3657,56,200,1,7,0,264
2608,35,3658,60,184,1,12,0,257
2609,35,3659,77,203,4,7,0,291
2610,35,3660,79,184,1,9,0,273
2611,35,3661,75,175,0,9,0,259
2612,35,3662,59,199,1,9,0,268
2613,35,3663,79,182,4,0,0,265
2614,35,3664,70,185,1,3,0,259
2615,35,3665,69,183,3,12,0,267
2616,35,3666,70,203,4,0,0,277
2617,35,3667,81,185,1,3,0,270
2618,040A,3803,68,218,0,2,0,288
2619,040A,3804,80,206,0,1,0,287
2620,040A,3805,86,193,1,9,0,289
2621,040A,3806,67,222,2,1,0,292
2622,040A,3807,67,198,3,5,5,278
2623,040A,3808,76,204,3,0,0,283
2624,040A,3809,77,202,5,4,0,288
2625,040A,3810,79,216,3,0,1,299
2626,040A,3811,65,220,2,2,0,289
2627,040A,3812,92,196,4,3,0,295
2628,040A,3813,87,202,3,5,0,297
2629,040A,3814,84,207,1,1,0,293
2630,040A,3815,72,217,2,4,0,295
2631,040A,3816,69,203,4,1,0,277
2632,040A,3817,63,210,2,2,1,278
2633,040A,3818,76,204,5,0,0,285
2634,040A,3819,71,219,3,5,0,298
2635,040A,3820,90,189,4,4,0,287
2636,040A,3821,73,214,5,6,0,298
2637,040A,3822,84,192,4,5,0,285
2638,040A,3823,79,203,2,3,0,287
2639,040A,3824,64,224,3,6,1,298
2640,040A,3825,76,217,4,0,0,297
2641,040A,3826,70,200,6,5,0,281
2642,040A,3827,69,221,1,3,0,294
2643,040A,3828,67,205,3,8,0,283
2644,040A,3829,80,206,3,2,0,291
2645,040A,3830,76,210,3,6,0,295
2646,040A,3831,76,219,1,3,0,299
2647,033A,3603,20,191,0,7,0,218
2648,34,3604,74,185,0,4,0,263
2649,34,3605,78,182,0,0,0,260
2650,34,3606,84,187,8,0,0,279
2651,34,3607,72,200,0,5,0,277
2652,34,3608,83,182,2,4,0,271
2653,34,3609,55,208,9,0,0,272
2654,34,3610,86,184,0,5,0,275
2655,34,3611,73,179,1,4,0,257
2656,34,3612,84,176,0,1,0,261
2657,34,3613,80,175,0,2,0,257
2658,34,3614,78,192,1,1,0,272
2659,34,3615,79,190,1,4,0,274
2660,34,3616,76,175,6,8,0,265
2661,34,3617,66,170,1,8,0,245
2662,34,3618,97,170,0,1,0,268
2663,34,3619,60,201,4,1,0,266
2664,34,3620,69,192,4,0,0,265
2665,34,3621,82,172,0,3,0,257
2666,34,3622,67,192,7,0,0,266
2667,34,3623,83,183,1,4,0,271
2668,34,3624,74,201,0,2,0,277
2669,34,3625,64,204,0,7,0,275
2670,34,3626,80,202,1,1,0,284
2671,34,3627,75,198,2,7,0,282
2672,34,3628,82,182,2,3,0,269
2673,34,3629,97,167,3,6,0,273
2674,34,3630,79,193,2,2,0,276
2675,34,3631,84,167,5,5,0,261
2676,34,3632,90,193,0,3,0,286
2677,30,3485,75,209,3,3,0,290
2678,30,3486,59,211,1,3,0,274
2679,30,3487,61,201,9,0,0,271
2680,30,3488,57,227,0,3,3,290
2681,30,3489,80,179,5,0,0,264
2682,30,3490,69,196,0,4,0,269
2683,30,3491,63,214,3,0,0,280
2684,30,3492,68,186,1,4,0,259
2685,30,3493,54,229,3,0,0,286
2686,30,3494,64,200,4,8,0,276
2687,30,3495,65,195,3,1,0,264
2688,30,3496,33,243,0,5,0,281
2689,30,3497,65,191,1,4,0,261
2690,30,3498,64,186,2,5,0,257
2691,30,3499,64,210,1,1,0,276
2692,30,3500,65,209,0,4,0,278
2693,38,3727,66,188,1,6,0,261
2694,38,3728,75,191,1,3,0,270
2695,38,3729,81,188,3,3,0,275
2696,38,3730,64,211,1,2,0,278
2697,38,3731,85,191,3,1,0,280
2698,38,3732,73,202,5,0,0,280
2699,38,3733,64,203,3,3,0,273
2700,38,3734,80,197,2,3,0,282
2701,38,3735,91,164,2,7,0,264
2702,38,3736,90,177,3,5,0,275
2703,38,3737,67,185,5,10,0,267
2704,38,3738,85,170,3,5,0,263
2705,38,3739,81,188,1,1,0,271
2706,38,3740,85,173,3,4,0,265
2707,38,3741,51,213,4,2,0,270
2708,38,3742,73,184,3,5,0,265
2709,38,3743,61,194,2,13,0,270
2710,38,3744,65,190,2,13,0,270
2711,38,3745,69,204,0,2,0,275
2712,38,3746,82,192,2,9,0,285
2713,38,3747,72,200,2,3,0,277
2714,38,3748,59,183,3,6,0,251
2715,38,3749,109,163,1,3,0,276
2716,38,3750,74,200,5,3,0,282
2717,38,3751,76,196,0,3,1,276
2718,38,3752,83,195,1,2,0,281
2719,035A,3668,74,174,2,6,0,256
2720,035A,3669,74,178,1,3,0,256
2721,035A,3670,60,177,2,5,0,244
2722,28,3348,61,204,2,2,0,269
2723,28,3349,77,189,2,4,0,272
2724,28,3350,65,196,3,4,1,269
2725,28,3351,55,213,1,3,0,272
2726,28,3352,87,187,1,2,0,277
2727,28,3353,80,175,4,2,0,261
2728,28,3354,61,207,0,3,0,271
2729,28,3355,63,205,1,7,0,276
2730,28,3356,83,184,2,3,0,272
2731,28,3357,66,184,2,2,0,254
2732,28,3358,62,197,0,2,0,261
2733,28,3359,51,213,5,2,0,271
2734,28,3360,75,190,4,7,0,276
2735,28,3361,79,186,3,3,1,272
2736,28,3362,71,205,2,4,0,282
2737,28,3363,83,186,1,2,0,272
2738,28,3364,63,202,1,2,0,268
2739,28,3365,73,188,4,7,0,272
2740,28,3366,70,200,2,1,0,273
2741,28,3367,69,206,4,2,0,281
2742,28,3368,77,179,7,5,0,268
2743,28,3369,0,0,0,0,0,0
2744,28,3370,69,189,2,7,0,267
2745,28,3371,57,190,1,9,0,257
2746,28,3372,71,179,3,5,0,258
2747,28,3373,56,219,2,4,0,281
2748,28,3374,60,196,1,10,0,267
2749,28,3375,74,172,2,6,0,254
2750,28,3376,72,200,4,3,0,279
2751,28,3377,75,202,5,0,0,282
2752,28,3378,67,195,1,7,0,270
2753,28,3379,74,185,1,4,0,264
2754,28,3380,80,190,4,1,0,275
2755,28,3381,65,206,1,3,0,275
2756,28,3382,82,185,3,7,0,277
2757,28,3383,70,186,4,4,0,264
2758,28,3384,85,198,0,2,0,285
2759,28,3385,75,191,2,8,0,276
2760,28,3386,64,207,2,2,0,275
2761,28,3387,77,192,2,6,0,277
2762,28,3388,76,186,3,3,0,268
2763,28,3389,70,203,3,6,0,282
2764,28,3390,64,190,2,12,0,268
2765,28,3391,67,199,3,4,0,273
2766,28,3392,65,201,1,2,0,269
2767,28,3393,85,181,3,6,0,275
2768,28,3394,67,183,5,2,0,257
2769,28,3395,67,180,2,6,0,255
2770,28,3396,68,201,3,4,0,276
2771,28,3397,64,197,2,6,0,269
2772,28,3398,82,188,2,1,0,273
2773,33,3520,57,197,0,3,0,257
2774,33,3521,35,226,0,4,0,265
2775,33,3522,42,191,4,1,0,238
2776,33,3523,55,208,3,5,0,271
2777,33,3524,50,208,4,2,0,264
2778,33,3525,64,204,1,4,0,273
2779,33,3526,51,205,1,1,0,258
2780,33,3527,45,214,0,2,0,261
2781,33,3528,48,219,2,1,0,270
2782,33,3529,49,210,6,1,0,266
2783,33,3530,44,229,3,2,0,278
2784,33,3531,72,198,3,0,0,273
2785,33,3532,52,197,2,1,0,252
2786,33,3533,55,208,3,0,0,266
2787,33,3534,39,227,0,3,0,269
2788,33,3535,39,225,1,2,0,267
2789,33,3536,46,220,3,0,0,269
2790,33,3537,71,181,2,3,0,257
2791,33,3539,49,214,1,2,0,266
2792,33,3540,60,202,1,3,0,266
2793,33,3541,72,195,1,2,0,270
2794,33,3542,24,237,2,0,0,263
2795,33,3543,51,225,1,1,0,278
2796,33,3544,46,221,2,3,0,272
2797,33,3545,67,183,2,1,0,253
2798,33,3546,53,194,0,1,0,248
2799,33,3547,41,196,0,4,0,241
2800,33,3548,52,193,4,1,0,250
2801,33,3549,56,194,4,5,0,259
2802,33,3550,48,189,5,2,0,244
2803,33,3551,57,199,1,7,0,264
2804,33,3552,39,230,3,2,0,274
2805,33,3553,43,229,2,3,0,277
2806,33,3554,52,188,5,0,0,245
2807,33,3555,50,200,2,4,0,256
2808,33,3556,47,196,1,4,0,248
2809,33,3557,54,197,2,2,0,255
2810,33,3558,64,198,4,2,0,268
2811,33,3559,32,222,2,0,0,256
2812,33,3560,74,192,2,1,0,269
2813,33,3561,57,207,3,3,0,270
2814,33,3562,66,193,1,4,0,264
2815,33,3563,62,184,6,1,0,253
2816,33,3564,63,197,1,1,0,262
2817,33,3565,47,227,1,4,0,279
2818,33,3566,33,211,1,4,0,249
2819,33,3567,42,205,3,2,0,252
2820,33,3568,46,225,1,0,0,272
2821,33,3569,44,236,0,6,0,286
2822,33,3570,31,216,0,7,0,254
2823,33,3571,45,204,2,6,0,257
2824,33,3572,61,202,5,1,0,269
2825,33,3573,55,192,4,6,0,257
2826,33,3574,48,208,3,2,0,261
2827,33,3575,48,203,1,5,0,257
2828,33,3576,61,197,1,4,0,263
2829,33,3577,46,216,1,0,0,263
2830,33,3578,61,207,1,3,0,272
2831,33,3579,52,215,3,5,0,275
2832,33,3580,59,215,0,1,0,275
2833,33,3581,50,201,2,2,0,255
2834,33,3582,55,223,2,3,0,283
2835,33,3583,52,194,2,2,0,250
2836,33,3584,50,198,1,3,0,252
2837,33,3585,55,193,2,1,0,251
2838,33,3586,52,204,1,3,0,260
2839,33,3587,40,206,2,2,0,250
2840,33,3588,66,186,3,2,0,257
2841,33,3589,48,210,4,2,0,264
2842,33,3590,68,190,0,0,0,258
2843,33,3591,53,200,3,4,0,260
2844,33,3592,38,224,3,4,0,269
2845,33,3593,50,201,4,1,0,256
2846,33,3594,40,213,3,2,0,258
2847,33,3595,49,214,4,4,0,271
2848,33,3596,58,213,1,10,0,282
2849,33,3597,40,224,2,1,0,267
2850,33,3598,41,208,1,2,0,252
2851,33,3599,70,185,1,2,0,258
2852,33,3600,52,197,1,0,0,250
2853,33,3601,39,222,2,3,0,266
2854,33,3602,55,239,2,2,0,298
2855,39,3753,18,27,0,0,0,45
2856,335,7746,125,116,3,2,0,246
2857,335,7747,92,144,4,0,0,240
2858,335,7748,105,139,0,2,0,246
2859,335,7749,139,111,1,5,0,256
2860,335,7750,112,137,1,4,0,254
2861,335,7751,142,119,3,0,0,264
2862,335,7752,106,117,2,4,0,229
2863,335,7753,108,135,2,2,0,247
2864,334,7745,142,109,4,0,0,255
2865,332,7741,49,119,3,0,0,171
2866,332,7742,40,138,2,1,0,181
2867,333,7743,76,108,5,0,0,189
2868,333,7744,50,116,4,0,0,170
2869,46,4034,142,38,1,2,0,183
2870,46,4035,139,48,0,1,0,188
2871,46,4036,137,32,0,0,0,169
2872,053A,4055,15,9,0,0,1,25
2873,043A,3952,62,58,2,0,0,122
2874,043B,3953,44,104,2,4,0,154
2875,42,3948,46,142,7,0,0,195
2876,42,3949,114,43,7,0,0,164
2877,42,3950,138,54,0,1,0,193
2878,044A,4028,144,111,0,2,0,257
2879,044A,4029,134,122,0,0,0,256
2880,046B,4037,74,65,0,0,0,139
2881,046B,4038,75,51,3,0,0,129
2882,043C,3954,0,2,0,0,0,2
2883,051A,4052,31,23,2,0,0,56
2884,53,4054,6,8,0,0,0,14
2885,54,4057,145,97,7,5,0,254
2886,54,4058,140,111,3,4,0,258
2887,54,4059,141,86,2,8,0,237
2888,54,4060,148,103,1,4,0,256
2889,54,4061,149,91,0,9,4,253
2890,54,4062,165,78,5,8,0,256
2891,54,4063,125,124,3,4,0,256
2892,055A,4073,56,36,1,0,0,93
2893,57,4095,172,53,4,0,0,229
2894,57,4096,187,43,1,0,0,231
2895,57,4097,183,49,3,0,0,235
2896,57,4098,187,49,6,0,0,242
2897,56,4074,92,156,1,5,0,254
2898,56,4075,113,160,7,0,0,280
2899,56,4076,116,132,1,2,0,251
2900,56,4077,114,136,6,0,0,256
2901,56,4078,95,152,4,0,0,251
2902,56,4079,93,157,1,2,0,253
2903,56,4080,91,145,0,12,0,248
2904,56,4081,104,150,4,0,0,258
2905,56,4082,110,142,2,2,0,256
2906,56,4083,104,140,1,1,0,246
2907,56,4084,97,146,0,4,0,247
2908,56,4085,111,149,2,6,0,268
2909,56,4086,106,150,1,3,0,260
2910,56,4087,102,145,1,2,0,250
2911,56,4088,130,110,2,2,0,244
2912,56,4089,99,146,1,1,0,247
2913,56,4090,87,175,2,6,0,270
2914,56,4091,100,167,4,6,0,277
2915,56,4092,107,143,2,3,0,255
2916,56,4093,74,185,3,2,0,264
2917,56,4094,81,192,2,2,0,277
2918,55,4065,143,84,0,0,0,227
2919,55,4066,147,84,1,3,0,235
2920,55,4067,143,72,1,1,0,217
2921,55,4068,130,95,0,2,0,227
2922,55,4069,153,67,0,0,0,220
2923,55,4070,141,88,2,2,0,233
2924,55,4071,166,56,4,1,0,227
2925,55,4072,148,76,1,1,0,226
2926,48,4040,103,108,1,0,0,212
2927,48,4041,106,108,1,1,0,216
2928,51,4049,179,77,0,3,0,259
2929,51,4050,170,70,0,0,0,240
2930,51,4051,177,61,1,1,0,240
2931,52,4053,48,44,0,0,1,93
2932,053B,4056,8,8,0,0,0,16
2933,44,3955,114,133,3,5,0,255
2934,44,3956,106,147,1,5,0,259
2935,44,3957,138,115,0,0,0,253
2936,44,3958,102,161,0,3,0,266
2937,44,3959,96,153,1,1,0,251
2938,44,3960,135,132,4,2,0,273
2939,44,3961,122,138,0,2,0,262
2940,44,3962,123,110,3,2,1,239
2941,44,3963,135,134,0,2,0,271
2942,44,3964,91,177,2,6,0,276
2943,44,3965,104,158,1,0,0,263
2944,44,3966,105,155,0,2,0,262
2945,44,3967,130,133,3,4,0,270
2946,44,3968,103,149,1,5,0,258
2947,44,3969,114,130,1,3,0,248
2948,44,3970,130,120,0,0,0,250
2949,44,3971,117,155,0,0,0,272
2950,44,3972,128,126,0,3,0,257
2951,44,3973,95,170,1,1,0,267
2952,44,3974,116,133,1,0,0,250
2953,44,3975,130,128,1,1,0,260
2954,44,3976,120,124,0,2,0,246
2955,44,3977,123,124,3,2,0,252
2956,44,3978,113,156,1,3,0,273
2957,44,3979,93,101,1,2,0,197
2958,44,3980,111,151,1,1,0,264
2959,44,3981,98,151,3,5,0,257
2960,44,3982,116,114,4,3,0,237
2961,44,3983,124,122,1,2,0,249
2962,44,3984,117,135,0,3,2,257
2963,44,3985,120,131,0,2,0,253
2964,44,3986,138,126,1,1,0,266
2965,44,3987,124,144,1,4,0,273
2966,44,3988,97,172,0,3,0,272
2967,44,3989,101,142,7,3,0,253
2968,44,3990,134,125,2,2,0,263
2969,44,3991,110,138,2,2,0,252
2970,44,3992,122,125,3,1,0,251
2971,44,3993,96,160,1,4,0,261
2972,44,3994,91,179,1,2,0,273
2973,44,3995,107,142,0,5,0,254
2974,44,3996,114,152,1,2,0,269
2975,44,3997,124,133,1,0,0,258
2976,44,3998,127,134,0,2,0,263
2977,44,3999,121,135,0,2,0,258
2978,44,4000,128,124,1,5,0,258
2979,44,4001,111,142,1,2,0,256
2980,44,4002,130,120,1,3,0,254
2981,44,4003,109,137,1,4,0,251
2982,44,4004,120,125,1,0,0,246
2983,44,4005,109,110,0,0,0,219
2984,44,4006,113,142,4,5,0,264
2985,44,4007,120,135,4,3,0,262
2986,44,4008,112,136,3,2,0,253
2987,44,4009,109,130,1,6,0,246
2988,44,4010,96,154,0,5,0,255
2989,44,4011,128,120,0,1,0,249
2990,44,4012,130,120,1,4,0,255
2991,44,4013,151,123,0,1,0,275
2992,44,4014,136,119,1,0,0,256
2993,44,4015,112,138,1,3,1,255
2994,44,4016,117,126,2,2,0,247
2995,44,4017,121,130,0,3,1,255
2996,44,4018,129,124,0,6,0,259
2997,44,4019,115,149,1,3,0,268
2998,44,4020,104,153,3,0,0,260
2999,44,4021,117,136,1,3,0,257
3000,44,4022,96,157,3,2,0,258
3001,44,4023,106,168,0,5,0,279
3002,44,4024,123,119,2,1,0,245
3003,44,4025,116,134,4,0,0,254
3004,44,4026,134,132,2,3,0,271
3005,44,4027,108,147,5,3,0,263
3006,054A,4064,23,37,1,0,0,61
3007,47,4039,35,10,0,0,0,45
3008,49,4042,35,27,1,2,0,65
3009,050A,4046,115,41,2,0,0,158
3010,050A,4047,124,56,1,0,0,181
3011,050A,4048,128,55,0,1,0,184
3012,45,4030,139,81,0,1,0,221
3013,45,4031,124,98,4,2,0,228
3014,45,4032,121,78,0,3,0,202
3015,45,4033,128,91,2,0,0,221
3016,43,3951,9,13,1,0,0,23
3017,50,4043,144,63,2,5,0,214
3018,50,4044,123,88,0,0,0,211
3019,50,4045,136,70,0,1,0,207
3020,140A,5041,40,19,0,0,0,59
3021,142,5044,120,133,0,3,0,256
3022,142,5045,97,154,3,8,0,262
3023,142,5046,118,136,0,3,0,257
3024,142,5047,108,152,1,6,0,267
3025,142,5048,103,155,5,0,0,263
3026,142,5049,105,147,3,5,0,260
3027,139B,5039,84,72,0,4,0,160
3028,139,5037,101,79,2,4,0,186
3029,138,5029,92,102,3,4,0,201
3030,138,5030,100,65,0,3,0,168
3031,138,5031,120,86,2,0,0,208
3032,142A,5050,71,41,3,1,0,116
3033,141A,5043,77,31,0,0,0,108
3034,138B,5033,53,17,0,0,0,70
3035,139A,5038,37,13,1,1,0,52
3036,140,5040,91,51,2,2,0,146
3037,138D,5036,90,23,1,2,0,116
3038,141,5042,19,16,0,0,0,35
3039,138C,5034,67,46,1,0,0,114
3040,138C,5035,77,49,1,0,0,127
3041,138A,5032,13,3,0,0,0,16
3042,237A,6411,106,153,1,7,0,267
3043,237A,6412,85,164,0,3,0,252
3044,237A,6413,66,182,5,0,0,253
3045,236A,6393,19,19,1,0,0,39
3046,231,6353,31,114,1,2,0,148
3047,231,6354,25,131,0,3,0,159
3048,232,6355,53,215,3,0,0,271
3049,232,6356,56,207,5,0,0,268
3050,232,6357,59,207,5,2,0,273
3051,232,6358,55,205,6,0,0,266
3052,232,6359,69,201,7,0,0,277
3053,243,6510,65,214,2,0,0,281
3054,243,6511,81,195,1,5,0,282
3055,243,6512,91,167,5,3,0,266
3056,243,6513,106,169,2,9,0,286
3057,243,6514,83,166,2,12,0,263
3058,243,6515,59,199,6,8,0,272
3059,243,6516,68,200,5,6,0,279
3060,243,6517,89,191,4,3,0,287
3061,243,6518,64,221,2,4,0,291
3062,243,6519,84,192,6,0,0,282
3063,243,6520,75,190,0,5,0,270
3064,243,6521,96,187,0,9,0,292
3065,243,6522,91,172,2,8,0,273
3066,243,6523,82,188,0,0,0,270
3067,243,6524,67,203,5,0,0,275
3068,243,6525,86,193,1,5,0,285
3069,243,6526,99,166,2,6,0,273
3070,243,6527,75,197,4,6,0,282
3071,243,6528,53,214,2,3,0,272
3072,243,6529,67,186,3,3,0,259
3073,243,6530,84,194,1,3,0,282
3074,243,6531,93,162,1,3,0,259
3075,243,6532,78,180,1,7,0,266
3076,243,6533,92,169,2,5,0,268
3077,243,6534,72,193,0,11,0,276
3078,243,6535,87,184,1,7,0,279
3079,243,6536,64,211,10,0,0,285
3080,243,6537,63,204,0,9,0,276
3081,243,6538,59,213,5,9,0,286
3082,243,6539,76,192,3,3,0,274
3083,243,6540,81,187,2,6,0,276
3084,243,6541,79,197,3,3,0,282
3085,243,6542,79,199,1,3,0,282
3086,243,6543,84,194,0,6,0,284
3087,243,6544,72,200,5,3,0,280
3088,243,6545,80,184,2,1,0,267
3089,243,6546,82,181,1,7,0,271
3090,243,6547,73,204,2,3,0,282
3091,243,6548,74,196,0,4,0,274
3092,243,6549,78,218,2,0,0,298
3093,243,6550,89,174,1,11,0,275
3094,243,6551,92,174,4,4,0,274
3095,243,6552,67,218,1,3,0,289
3096,243,6553,75,212,11,0,0,298
3097,243,6554,84,188,6,4,0,282
3098,243,6555,88,181,1,5,0,275
3099,243,6556,73,197,1,9,0,280
3100,243,6557,84,159,3,8,0,254
3101,243,6558,84,185,1,9,0,279
3102,243,6559,56,199,3,7,0,265
3103,243,6560,71,207,0,4,0,282
3104,243,6561,85,180,1,6,0,272
3105,242,6507,51,117,1,2,0,171
3106,242,6508,41,133,1,7,0,182
3107,244A,6570,25,193,1,2,0,221
3108,238,6415,50,215,4,0,0,269
3109,238,6416,88,177,1,7,0,273
3110,238,6417,68,195,1,3,0,267
3111,234,6364,82,187,7,0,0,276
3112,234,6365,79,190,3,1,0,273
3113,234,6366,72,186,0,8,0,266
3114,234,6367,65,226,6,0,0,297
3115,233,6360,73,202,2,1,0,278
3116,233,6361,96,175,1,8,0,280
3117,233,6362,79,198,2,5,0,284
3118,233,6363,77,195,16,0,0,288
3119,239,6418,88,183,3,3,0,277
3120,239,6419,97,168,0,5,0,270
3121,239,6420,84,211,2,10,0,307
3122,239,6421,76,214,1,3,0,294
3123,239,6422,65,223,6,2,0,296
3124,239,6423,109,188,6,0,0,303
3125,239,6424,87,190,5,0,0,282
3126,239,6425,95,183,2,3,0,283
3127,239,6426,75,217,1,5,0,298
3128,239,6427,79,203,4,4,0,290
3129,239,6428,62,216,2,6,0,286
3130,239,6429,106,182,4,9,0,301
3131,239,6430,69,200,3,2,0,274
3132,239,6431,90,196,7,0,0,293
3133,239,6432,82,204,3,2,0,291
3134,239,6433,86,178,3,2,0,269
3135,239,6434,87,185,6,2,0,280
3136,239,6435,114,156,6,6,0,282
3137,239,6436,98,168,0,10,0,276
3138,239,6437,96,187,2,7,0,292
3139,239,6438,63,212,3,4,0,282
3140,239,6439,79,197,2,7,0,285
3141,239,6440,79,211,1,2,0,293
3142,239,6441,78,206,3,4,0,291
3143,239,6442,68,189,6,5,0,268
3144,239,6443,105,178,2,3,0,288
3145,239,6444,88,196,5,0,0,289
3146,239,6445,88,185,3,4,0,280
3147,239,6446,85,195,5,8,0,293
3148,239,6447,62,219,3,3,0,287
3149,239,6448,75,202,2,4,0,283
3150,239,6449,100,176,5,7,0,288
3151,239,6450,85,200,2,10,0,297
3152,239,6451,112,178,1,4,0,295
3153,239,6452,95,187,6,1,0,289
3154,236,6388,48,222,3,0,0,273
3155,236,6389,41,221,9,0,0,271
3156,236,6390,64,181,9,0,0,254
3157,236,6391,44,226,10,0,0,280
3158,236,6392,34,229,3,0,0,266
3159,230A,6351,55,233,1,0,0,289
3160,230A,6352,55,232,4,0,0,291
3161,244,6562,62,183,5,0,0,250
3162,244,6563,41,211,3,0,0,255
3163,244,6564,50,193,0,3,0,246
3164,244,6565,41,188,3,2,0,234
3165,244,6566,62,181,2,2,0,247
3166,244,6567,51,190,0,5,0,246
3167,244,6568,46,195,2,0,0,243
3168,244,6569,46,186,1,5,0,238
3169,242A,6509,1,12,0,0,0,13
3170,240,6453,83,186,1,3,0,273
3171,240,6454,78,193,1,6,0,278
3172,240,6455,92,163,0,5,0,260
3173,240,6456,79,195,2,1,0,277
3174,240,6457,65,223,2,0,0,290
3175,240,6458,70,198,1,5,0,274
3176,240,6459,64,213,1,6,0,284
3177,240,6460,59,209,0,6,0,274
3178,240,6461,56,226,3,2,0,287
3179,240,6462,79,189,5,4,0,277
3180,240,6463,90,186,1,7,0,284
3181,240,6464,85,176,2,5,0,268
3182,240,6465,77,199,5,2,0,283
3183,240,6466,52,216,1,7,0,276
3184,240,6467,71,215,3,7,0,296
3185,240,6468,82,191,2,3,0,278
3186,240,6469,74,190,3,11,0,278
3187,240,6470,78,194,9,0,0,281
3188,240,6471,89,172,0,4,0,265
3189,240,6472,95,167,2,6,0,270
3190,240,6473,46,234,1,2,0,283
3191,240,6474,61,201,4,6,0,272
3192,240,6475,88,188,3,3,0,282
3193,240,6476,74,197,1,2,0,274
3194,240,6477,82,186,0,4,0,272
3195,240,6478,86,182,2,3,0,273
3196,240,6479,68,216,0,7,0,291
3197,240,6480,59,205,6,3,0,273
3198,240,6481,76,186,7,0,0,269
3199,240,6482,84,193,5,0,0,282
3200,240,6483,68,211,0,3,0,282
3201,240,6484,69,224,3,1,0,297
3202,240,6485,80,198,4,3,0,285
3203,240,6486,85,175,0,11,0,271
3204,240,6487,62,203,0,13,0,278
3205,240,6488,89,187,1,2,0,279
3206,240,6489,73,195,4,5,0,277
3207,237,6394,77,190,2,2,0,271
3208,237,6395,69,186,3,14,0,272
3209,237,6396,82,187,3,7,0,279
3210,237,6397,79,179,2,5,0,265
3211,237,6398,62,194,1,2,0,259
3212,237,6399,63,200,1,6,0,270
3213,237,6400,74,195,1,7,0,277
3214,237,6401,83,179,2,5,0,269
3215,237,6402,72,200,0,2,0,274
3216,237,6403,86,172,3,4,0,265
3217,237,6404,90,169,0,7,0,266
3218,237,6405,91,174,4,3,0,272
3219,237,6406,65,211,1,3,0,280
3220,237,6407,73,184,2,0,0,259
3221,237,6408,62,192,0,1,0,255
3222,237,6409,56,200,4,11,0,271
3223,237,6410,60,214,0,7,0,281
3224,235,6368,58,229,0,4,0,291
3225,235,6369,59,233,1,3,0,296
3226,235,6370,52,221,3,0,0,276
3227,235,6371,58,229,1,4,0,292
3228,235,6372,72,219,0,1,0,292
3229,235,6373,50,248,0,5,0,303
3230,235,6374,52,221,3,4,0,280
3231,235,6375,70,208,1,0,0,279
3232,235,6376,61,210,6,2,0,279
3233,235,6377,66,209,4,7,0,286
3234,235,6378,62,195,2,8,0,267
3235,235,6379,68,212,7,0,0,287
3236,235,6380,59,235,1,5,0,300
3237,235,6381,56,224,4,3,0,287
3238,235,6382,71,214,3,2,0,290
3239,235,6383,54,230,0,6,0,290
3240,235,6384,70,220,2,1,0,293
3241,235,6385,64,218,1,5,0,288
3242,235,6386,69,210,3,6,0,288
3243,235,6387,65,215,2,7,0,289
3244,237B,6414,81,72,0,0,0,153
3245,245,6571,86,158,1,2,0,247
3246,245,6572,73,213,2,5,0,293
3247,245,6573,77,194,4,2,0,277
3248,245,6574,65,208,3,5,0,281
3249,245,6575,61,212,5,5,0,283
3250,245,6576,37,239,1,3,0,280
3251,245,6577,52,231,0,3,0,286
3252,245,6578,55,216,1,1,0,273
3253,245,6579,51,224,2,1,0,278
3254,245,6580,70,207,2,3,0,282
3255,245,6581,69,219,1,3,0,292
3256,245,6582,59,232,2,3,0,296
3257,245,6583,65,214,1,6,0,286
3258,245,6584,62,210,3,0,0,275
3259,245,6585,65,208,1,5,0,279
3260,245,6586,46,244,0,1,0,291
3261,245,6587,69,196,4,6,0,275
3262,245,6588,43,217,1,2,0,263
3263,245,6589,58,209,0,5,0,272
3264,245,6590,71,206,1,3,0,281
3265,245,6591,87,168,0,3,0,258
3266,245,6592,86,182,4,2,0,274
3267,245,6593,46,234,1,5,0,286
3268,245,6594,68,219,1,1,0,289
3269,245,6595,68,203,2,5,0,278
3270,245,6596,73,190,1,6,0,270
3271,245,6597,52,228,2,4,0,286
3272,245,6598,79,184,1,8,0,272
3273,245,6599,53,230,0,4,0,287
3274,245,6600,64,212,1,2,0,279
3275,245,6601,60,213,7,6,0,286
3276,245,6602,62,234,4,2,0,302
3277,245,6603,62,195,1,9,0,267
3278,245,6604,86,184,1,3,0,274
3279,245,6605,71,212,0,2,0,285
3280,245,6606,64,206,3,4,0,277
3281,245,6607,64,205,4,5,0,278
3282,245,6608,65,216,0,5,0,286
3283,230,6344,190,53,3,0,0,246
3284,230,6345,65,185,2,3,0,255
3285,230,6346,61,188,3,0,0,252
3286,230,6347,59,195,8,0,0,262
3287,230,6348,57,200,7,0,0,264
3288,230,6349,74,172,4,0,0,250
3289,230,6350,63,191,1,3,0,258
3290,241,6490,81,188,3,0,0,272
3291,241,6491,60,196,1,8,0,265
3292,241,6492,43,225,2,6,0,276
3293,241,6493,63,191,5,4,0,263
3294,241,6494,53,198,2,2,0,255
3295,241,6495,42,227,1,3,0,273
3296,241,6496,58,196,2,0,0,256
3297,241,6497,74,185,0,0,0,259
3298,241,6498,61,187,0,3,0,251
3299,241,6499,62,220,1,1,0,284
3300,241,6500,46,220,3,2,0,271
3301,241,6501,70,173,3,9,0,255
3302,241,6502,83,176,1,5,0,265
3303,241,6503,75,195,1,3,0,274
3304,241,6504,65,192,1,3,0,261
3305,241,6505,57,218,1,2,0,278
3306,241,6506,73,185,1,3,0,262
3307,275A,6937,173,87,0,5,0,265
3308,275A,6938,133,115,1,0,0,249
3309,275A,6939,172,95,0,0,0,267
3310,275A,6940,171,88,0,0,0,259
3311,275A,6941,169,96,1,0,0,266
3312,275A,6942,173,81,3,1,0,258
3313,268,6809,113,142,3,4,0,262
3314,268,6810,108,155,2,3,0,268
3315,268,6811,98,156,1,4,0,259
3316,268,6812,99,168,2,5,0,274
3317,268,6813,144,133,2,5,0,284
3318,268,6814,112,164,8,4,0,288
3319,268,6815,102,169,1,7,0,279
3320,268,6816,102,173,3,2,0,280
3321,268,6817,84,187,2,2,0,275
3322,268,6818,138,142,3,2,0,285
3323,268,6819,83,181,4,3,0,271
3324,268,6820,72,183,3,6,0,264
3325,268,6821,108,154,0,4,0,266
3326,268,6822,106,140,1,2,0,249
3327,268,6823,104,165,2,2,0,273
3328,268,6824,79,196,4,4,0,283
3329,268,6825,79,195,0,8,0,282
3330,268,6826,117,155,3,5,0,280
3331,268,6827,86,200,0,0,0,286
3332,268,6828,102,160,3,4,0,269
3333,268,6829,126,145,1,3,0,275
3334,268,6830,62,194,2,4,0,262
3335,268,6831,103,180,1,1,0,285
3336,268,6832,77,177,1,4,0,259
3337,268,6833,133,135,3,5,0,276
3338,268,6834,95,177,3,3,0,278
3339,268,6835,100,168,1,4,0,273
3340,268,6836,79,198,5,0,0,282
3341,268,6837,89,182,0,7,0,278
3342,268,6838,90,185,3,0,0,278
3343,268,6839,121,147,1,3,0,272
3344,268,6840,120,148,4,0,0,272
3345,268,6841,120,141,2,3,0,266
3346,268,6842,112,149,2,2,0,265
3347,268,6843,79,186,4,0,0,269
3348,268,6844,108,153,0,3,1,265
3349,268,6845,111,166,3,1,0,281
3350,268,6846,94,159,0,4,0,257
3351,268,6847,114,158,2,1,0,275
3352,268,6848,97,169,2,3,0,271
3353,268,6849,101,172,1,5,0,279
3354,268,6850,111,164,1,2,0,278
3355,268,6851,100,182,3,3,0,288
3356,268,6852,92,181,3,4,0,280
3357,268,6853,112,155,1,3,0,271
3358,268,6854,111,157,3,0,0,271
3359,268,6855,110,148,1,5,0,264
3360,268,6856,87,184,1,5,0,277
3361,268,6857,85,176,4,0,0,265
3362,268,6858,99,172,4,4,0,279
3363,268,6859,100,179,2,4,0,285
3364,268,6860,114,172,7,0,0,293
3365,268,6861,100,176,1,7,0,284
3366,268,6862,120,169,2,0,0,291
3367,268,6863,127,148,1,2,0,278
3368,268,6864,100,174,2,3,0,279
3369,268,6865,99,170,4,5,0,278
3370,268,6866,112,172,2,0,0,286
3371,268,6867,98,161,2,7,0,268
3372,268,6868,90,180,3,4,0,277
3373,268,6869,86,176,3,4,0,269
3374,268,6870,98,161,1,3,0,263
3375,268,6871,86,181,1,2,0,270
3376,268,6872,103,161,2,1,0,267
3377,268,6873,118,151,1,6,0,276
3378,268,6874,93,182,0,0,0,275
3379,268,6875,87,195,2,1,0,285
3380,268,6876,106,169,1,2,0,278
3381,268,6877,115,152,2,4,0,273
3382,268,6878,100,175,5,3,0,283
3383,268,6879,97,164,4,3,0,268
3384,268,6880,100,181,2,3,0,286
3385,268,6881,108,165,2,2,0,277
3386,268,6882,91,151,9,5,0,256
3387,268,6883,72,183,2,4,0,261
3388,268,6884,113,168,3,2,0,286
3389,268,6885,112,153,0,6,0,271
3390,268,6886,96,156,2,2,0,256
3391,268,6887,101,175,3,2,0,281
3392,269,6888,122,128,3,0,0,253
3393,269,6889,106,136,4,0,0,246
3394,269,6890,102,138,6,0,0,246
3395,269,6891,113,128,10,0,0,251
3396,269,6892,123,115,8,0,1,247
3397,269,6893,164,92,0,2,0,258
3398,269,6894,137,102,3,5,0,247
3399,269,6895,115,129,8,0,0,252
3400,269,6896,123,100,3,4,0,230
3401,274,6925,85,97,4,2,0,188
3402,274,6926,76,90,1,1,0,168
3403,274,6927,96,88,2,4,0,190
3404,274A,6928,112,84,3,6,0,205
3405,274A,6929,111,75,0,3,0,189
3406,272,6917,93,120,4,6,0,223
3407,272,6918,104,113,2,2,0,221
3408,272,6919,72,151,1,2,0,226
3409,272,6920,95,124,7,3,0,229
3410,270,6899,134,123,2,5,0,264
3411,270,6900,105,155,7,4,0,271
3412,270,6901,121,145,5,8,0,279
3413,270,6902,114,141,8,0,0,263
3414,270,6903,143,125,7,0,0,275
3415,270,6904,129,140,5,7,0,281
3416,270,6905,120,143,3,6,0,272
3417,270,6906,145,114,1,6,0,266
3418,270,6907,126,131,5,3,0,265
3419,270,6908,122,124,1,6,0,253
3420,270,6909,128,130,1,7,0,266
3421,270,6910,124,145,1,1,0,271
3422,270,6911,114,146,4,13,0,277
3423,276,6943,97,138,7,8,0,250
3424,276,6944,112,111,2,5,0,230
3425,276,6945,110,119,3,5,0,237
3426,276,6946,97,119,4,5,0,225
3427,273,6921,136,108,4,2,0,250
3428,273,6922,158,80,6,5,0,249
3429,273,6923,155,89,2,3,0,249
3430,273,6924,132,119,0,3,0,254
3431,275,6930,134,103,4,0,0,241
3432,275,6931,123,136,0,3,0,262
3433,275,6932,128,107,3,3,0,241
3434,275,6933,122,127,3,0,0,252
3435,275,6934,117,130,1,0,0,248
3436,275,6935,141,112,1,0,0,254
3437,275,6936,110,139,2,1,0,252
3438,269B,6898,10,6,1,0,0,17
3439,267,6807,103,47,0,2,0,152
3440,267,6808,78,72,2,2,0,154
3441,271,6912,118,132,1,3,0,254
3442,271,6913,113,138,2,1,0,254
3443,271,6914,128,124,0,2,0,254
3444,271,6915,120,126,0,0,0,246
3445,271,6916,104,127,2,3,0,236
3446,269A,6897,114,81,1,2,0,198
3447,137,5026,31,164,0,0,0,195
3448,137,5027,34,178,6,0,0,218
3449,137,5028,28,175,6,0,0,209
3450,134,5001,111,169,3,0,0,283
3451,134,5002,94,175,8,0,0,277
3452,134,5003,75,183,2,3,0,263
3453,134,5004,67,207,1,10,0,285
3454,134,5005,84,193,4,0,0,281
3455,134,5006,97,176,4,0,0,277
3456,134,5007,80,195,3,0,0,278
3457,134,5008,124,167,6,0,0,297
3458,134,5009,94,188,11,0,0,293
3459,134,5010,89,192,5,2,0,288
3460,134,5011,100,162,1,3,0,266
3461,134,5012,78,203,2,0,0,283
3462,134,5013,100,180,2,0,0,282
3463,134,5014,67,215,2,4,0,288
3464,134,5015,94,186,10,0,0,290
3465,134,5016,87,199,1,3,0,290
3466,131A,4924,3,21,0,0,0,24
3467,123,4800,90,173,3,0,0,266
3468,123,4801,70,188,1,0,0,259
3469,123,4802,67,188,3,0,0,258
3470,123,4803,82,173,3,0,0,258
3471,123,4804,55,195,5,0,0,255
3472,123,4805,79,177,6,0,0,262
3473,123,4806,66,177,5,0,0,248
3474,123,4807,65,209,1,0,0,275
3475,123,4808,89,160,7,0,0,256
3476,123,4809,79,193,6,0,0,278
3477,123,4810,78,187,6,0,0,271
3478,123,4811,58,208,3,0,0,269
3479,123,4812,77,172,4,0,0,253
3480,129,4882,115,147,6,0,0,268
3481,129,4883,74,170,7,0,0,251
3482,129,4884,79,169,5,0,0,253
3483,129,4885,92,159,5,0,0,256
3484,129,4886,76,177,5,0,0,258
3485,129,4887,100,158,0,0,0,258
3486,129,4888,72,183,8,0,0,263
3487,129,4889,100,141,5,0,0,246
3488,129,4890,77,175,0,3,0,255
3489,129,4891,91,161,5,4,0,261
3490,129,4892,80,182,4,0,0,266
3491,129,4893,77,194,4,0,0,275
3492,128,4870,100,172,3,0,0,275
3493,128,4871,84,180,4,0,1,269
3494,128,4872,67,184,1,0,0,252
3495,128,4873,70,178,9,0,0,257
3496,128,4874,91,179,1,0,0,271
3497,128,4875,90,178,5,0,0,273
3498,128,4876,89,158,1,0,0,248
3499,128,4877,77,185,0,0,0,262
3500,128,4878,68,195,6,0,0,269
3501,128,4879,95,153,3,0,0,251
3502,128,4880,62,188,5,4,0,259
3503,126,4844,52,198,2,0,0,252
3504,126,4845,53,194,13,0,0,260
3505,126,4846,53,202,4,2,0,261
3506,126,4847,45,227,1,0,0,273
3507,126,4848,64,189,1,4,0,258
3508,126,4849,62,174,5,0,0,241
3509,126,4850,45,195,4,5,0,249
3510,126,4851,59,215,1,0,0,275
3511,126,4852,73,178,3,0,0,254
3512,126,4853,57,169,11,0,0,237
3513,126,4854,67,192,4,6,0,269
3514,126,4855,57,198,3,3,0,261
3515,126,4856,76,182,5,0,0,263
3516,126,4857,64,184,10,0,0,258
3517,126,4858,55,195,13,0,0,263
3518,126,4859,64,186,4,0,0,254
3519,126,4860,72,180,4,0,0,256
3520,126,4861,63,192,7,0,0,262
3521,126,4862,61,198,2,3,0,264
3522,125,4817,79,166,3,10,0,258
3523,125,4818,65,200,18,0,0,283
3524,125,4819,60,197,12,0,0,269
3525,125,4820,66,209,6,0,0,281
3526,125,4821,70,185,3,10,0,268
3527,125,4822,72,184,11,0,0,267
3528,125,4823,76,196,6,0,0,278
3529,125,4824,51,210,8,0,0,269
3530,125,4825,71,193,12,0,0,276
3531,125,4826,67,200,8,0,0,275
3532,125,4827,63,210,10,0,0,283
3533,125,4828,75,190,5,8,0,278
3534,125,4829,97,169,0,3,0,269
3535,125,4830,91,162,12,0,0,265
3536,125,4831,89,164,7,0,0,260
3537,125,4832,78,182,9,0,0,269
3538,125,4833,84,175,4,0,0,263
3539,125,4834,80,185,7,0,0,272
3540,125,4835,72,168,8,0,0,248
3541,125,4836,87,179,5,3,0,274
3542,125,4837,67,230,9,0,0,306
3543,125,4838,67,196,3,0,0,266
3544,125,4839,75,171,10,0,0,256
3545,125,4840,72,191,11,0,0,274
3546,125,4841,79,171,14,0,0,264
3547,125,4842,68,186,10,0,0,264
3548,125,4843,82,159,10,0,0,251
3549,127,4863,41,213,3,0,0,257
3550,127,4864,29,206,8,0,0,243
3551,127,4865,32,202,7,0,0,241
3552,127,4866,44,193,7,0,0,244
3553,127,4867,35,201,1,0,0,237
3554,127,4868,35,198,6,0,0,239
3555,127,4869,31,209,7,0,0,247
3556,131,4896,116,166,1,2,0,285
3557,131,4897,131,145,1,3,0,280
3558,131,4898,111,160,1,5,0,277
3559,131,4899,69,216,2,1,0,288
3560,131,4900,119,161,3,2,0,285
3561,131,4901,110,158,1,5,0,274
3562,131,4902,97,175,2,3,0,277
3563,131,4903,88,191,2,1,0,282
3564,131,4904,130,152,0,1,0,283
3565,131,4905,125,145,1,4,0,275
3566,131,4906,101,164,1,3,0,269
3567,131,4907,102,160,5,5,0,272
3568,131,4908,135,133,1,0,0,269
3569,131,4909,105,174,2,3,0,284
3570,131,4910,106,160,9,0,0,275
3571,131,4911,107,188,3,1,0,299
3572,131,4912,120,152,4,10,0,286
3573,131,4913,124,152,1,2,0,279
3574,131,4914,90,184,0,4,0,278
3575,131,4916,96,173,4,3,0,276
3576,131,4917,97,176,1,2,0,276
3577,131,4918,96,174,1,4,0,275
3578,131,4919,114,160,1,1,0,276
3579,131,4920,98,175,2,1,0,276
3580,131,4921,104,166,2,0,0,272
3581,131,4922,126,149,3,1,0,279
3582,131,4923,152,128,0,4,0,284
3583,119,4764,86,159,1,0,0,246
3584,119,4765,82,163,0,1,0,246
3585,119,4766,81,163,5,0,0,249
3586,119,4767,72,177,1,0,0,250
3587,119,4768,77,180,3,0,0,260
3588,119,4769,74,175,10,0,0,259
3589,119,4770,84,172,5,0,0,261
3590,119,4771,62,171,0,5,0,238
3591,119,4772,79,146,0,1,0,226
3592,119,4773,75,169,3,2,0,249
3593,135,5017,124,141,4,0,0,269
3594,121,4793,82,194,3,4,0,283
3595,121,4794,79,187,0,3,0,269
3596,121,4795,107,166,2,0,0,275
3597,121,4796,87,175,4,0,0,266
3598,121,4797,98,169,6,0,0,273
3599,121,4798,96,173,4,0,0,273
3600,130,4894,70,199,2,4,0,275
3601,130,4895,55,215,2,3,0,275
3602,132,4925,55,213,2,0,0,270
3603,132,4926,69,194,9,0,0,272
3604,132,4927,105,162,2,0,0,269
3605,132,4928,90,167,4,4,0,265
3606,132,4929,71,192,4,4,0,271
3607,132,4930,78,173,4,5,0,260
3608,132,4931,76,182,8,0,0,266
3609,132,4932,65,196,4,0,0,265
3610,133,4933,117,160,5,0,0,282
3611,133,4934,80,181,3,1,0,265
3612,133,4935,69,188,10,0,0,267
3613,133,4936,88,187,1,2,0,278
3614,133,4937,62,213,7,0,0,282
3615,133,4938,71,178,4,1,0,254
3616,133,4939,67,198,2,3,0,270
3617,133,4940,52,211,2,3,0,268
3618,133,4941,69,228,3,0,0,300
3619,133,4942,68,196,4,5,0,273
3620,133,4943,65,197,2,0,0,264
3621,133,4944,60,213,0,2,0,275
3622,133,4945,70,209,3,0,0,282
3623,133,4946,69,188,2,4,0,263
3624,133,4947,70,211,6,0,0,287
3625,133,4948,68,186,5,6,0,265
3626,133,4949,73,195,2,6,0,276
3627,133,4950,61,199,2,5,0,267
3628,133,4951,65,208,4,2,0,279
3629,133,4952,69,204,2,1,0,276
3630,133,4953,56,220,7,0,0,283
3631,133,4954,59,207,1,0,0,267
3632,133,4955,75,180,10,7,0,272
3633,133,4956,82,189,5,0,0,276
3634,133,4957,58,200,10,0,0,268
3635,133,4958,69,203,0,1,0,273
3636,133,4959,48,205,1,6,0,260
3637,133,4960,64,202,1,3,0,270
3638,133,4961,48,218,5,0,0,271
3639,133,4962,74,200,2,4,0,280
3640,133,4963,68,202,7,3,0,280
3641,133,4964,71,186,6,10,0,273
3642,133,4965,57,202,3,4,0,266
3643,133,4966,63,198,8,0,0,269
3644,133,4967,71,208,3,1,0,283
3645,133,4968,69,201,4,7,0,281
3646,133,4969,96,179,4,5,0,284
3647,133,4970,68,208,1,1,0,278
3648,133,4971,51,219,2,4,0,276
3649,133,4972,85,169,4,4,0,262
3650,133,4973,199,77,6,2,0,284
3651,133,4974,67,184,11,0,0,262
3652,133,4975,92,193,3,4,0,292
3653,133,4976,70,179,4,3,0,256
3654,133,4977,63,200,9,7,0,279
3655,133,4978,70,181,17,0,0,268
3656,133,4979,63,218,5,0,0,286
3657,133,4980,83,191,4,0,0,278
3658,133,4981,91,172,1,3,0,267
3659,133,4982,84,178,1,3,0,266
3660,133,4983,55,212,4,12,0,283
3661,133,4984,86,185,0,2,0,273
3662,133,4985,54,203,8,0,0,265
3663,133,4986,61,209,9,3,0,282
3664,133,4987,63,203,3,2,0,271
3665,133,4988,61,195,1,3,0,260
3666,133,4989,70,191,3,5,0,269
3667,133,4990,69,207,0,2,0,278
3668,133,4991,74,190,1,6,0,271
3669,133,4992,56,219,6,0,0,281
3670,133,4993,73,201,7,0,0,281
3671,133,4994,70,196,3,5,0,274
3672,133,4995,71,191,5,7,0,274
3673,133,4996,75,188,4,8,0,275
3674,133,4997,76,190,5,2,0,273
3675,133,4998,53,225,3,4,0,285
3676,133,4999,73,187,2,8,0,270
3677,133,5000,79,197,4,2,0,282
3678,136,5018,79,168,2,7,0,256
3679,136,5019,91,169,1,1,0,262
3680,136,5020,67,196,1,3,0,267
3681,136,5021,67,176,2,2,0,247
3682,136,5022,51,225,2,2,0,280
3683,136,5023,87,178,1,2,0,268
3684,136,5024,62,193,1,2,0,258
3685,136,5025,72,175,6,0,0,253
3686,120,4774,54,211,4,0,0,269
3687,120,4775,53,213,8,0,0,274
3688,120,4776,69,207,0,7,0,283
3689,120,4777,47,207,0,3,0,257
3690,120,4778,54,221,2,3,0,280
3691,120,4779,39,208,4,0,0,251
3692,120,4780,42,224,0,4,0,270
3693,120,4781,49,209,2,3,0,263
3694,120,4782,46,210,13,0,0,269
3695,120,4783,58,218,0,2,0,278
3696,120,4784,70,186,1,1,0,258
3697,120,4785,48,224,1,3,0,276
3698,120,4786,59,204,3,3,0,269
3699,120,4787,42,225,8,0,0,275
3700,120,4788,49,200,3,5,0,257
3701,120,4789,65,172,1,10,0,248
3702,120,4790,48,212,0,1,0,261
3703,120,4791,53,202,3,7,0,265
3704,120,4792,66,208,1,6,0,281
3705,124,4813,99,114,1,2,0,216
3706,124,4814,86,124,1,3,0,214
3707,124,4815,95,116,3,4,0,218
3708,124,4816,92,126,3,3,0,224
3709,128A,4881,53,57,1,0,0,111
3710,122,4799,84,107,2,0,0,193
3711,011F,1865,74,194,3,6,0,277
3712,011F,1866,63,198,0,4,0,265
3713,011F,1867,62,216,4,3,0,285
3714,011F,1868,55,210,3,3,0,271
3715,011F,1869,71,188,5,6,0,270
3716,011F,1870,76,183,3,2,0,264
3717,011F,1871,54,209,2,7,0,272
3718,011F,1872,55,211,1,6,0,273
3719,011F,1873,60,230,4,2,0,296
3720,011F,1874,54,207,2,3,0,266
3721,011F,1875,63,205,4,3,0,275
3722,011F,1876,67,198,1,4,0,270
3723,011F,1877,52,224,2,2,0,280
3724,011F,1878,60,193,1,7,0,261
3725,011F,1879,70,209,1,6,0,286
3726,011F,1880,57,193,1,9,0,260
3727,011F,1881,57,196,4,4,0,261
3728,011F,1882,89,202,2,3,0,296
3729,011F,1883,63,215,0,1,0,279
3730,011F,1884,68,210,2,3,0,283
3731,011F,1885,63,218,3,5,0,289
3732,011F,1886,52,201,2,5,0,260
3733,013N,2806,53,209,2,5,0,269
3734,013N,2807,58,200,3,2,0,263
3735,013N,2808,52,218,5,5,0,280
3736,013N,2809,52,197,5,3,0,257
3737,013N,2810,75,181,1,4,0,261
3738,013N,2811,54,212,4,2,0,272
3739,013N,2812,49,200,7,7,0,263
3740,013N,2813,58,212,2,1,0,273
3741,013N,2814,56,213,0,6,0,275
3742,013N,2815,52,201,4,8,0,265
3743,013N,2816,61,192,3,5,0,261
3744,013N,2817,49,216,2,7,0,274
3745,013N,2818,35,218,4,3,0,260
3746,013N,2819,57,203,2,3,0,265
3747,013N,2820,44,221,2,5,0,272
3748,013N,2821,59,210,2,1,1,273
3749,013N,2822,53,209,1,8,0,271
3750,013N,2823,59,201,4,3,0,267
3751,013N,2824,46,224,3,5,0,278
3752,013N,2825,59,208,1,4,0,272
3753,013N,2826,48,224,2,4,0,278
3754,013N,2827,60,208,5,4,0,277
3755,011H,1925,52,221,2,8,0,283
3756,011H,1926,46,220,6,1,0,273
3757,011H,1927,59,211,2,0,0,272
3758,011H,1928,53,215,7,0,0,275
3759,011H,1929,47,218,6,4,0,275
3760,011H,1930,35,226,0,4,0,265
3761,011H,1931,46,227,3,2,0,278
3762,011H,1932,60,221,4,2,0,287
3763,011H,1933,84,175,5,2,0,266
3764,011H,1934,58,217,4,2,0,281
3765,011H,1935,59,223,4,3,0,289
3766,011H,1936,61,213,3,8,0,285
3767,011H,1937,49,215,7,5,0,276
3768,011H,1938,47,223,5,1,0,276
3769,011H,1939,57,223,3,1,0,284
3770,011H,1940,41,240,3,2,0,286
3771,011H,1941,48,209,3,3,0,263
3772,011H,1942,63,220,2,2,0,287
3773,011H,1943,43,226,3,2,0,274
3774,011H,1944,59,217,4,2,0,282
3775,005C,373,73,193,2,4,0,272
3776,005C,374,64,212,1,4,0,281
3777,005C,375,58,208,2,5,0,273
3778,005C,376,46,210,4,8,1,269
3779,005C,377,59,190,4,9,0,262
3780,005C,378,56,225,1,1,0,283
3781,005C,379,34,229,3,8,0,274
3782,005C,380,62,212,1,7,0,282
3783,005C,381,59,218,1,7,0,285
3784,005C,382,52,208,0,6,0,266
3785,005C,383,64,187,2,6,0,259
3786,005C,384,55,220,6,6,0,287
3787,005C,385,46,224,0,4,0,274
3788,005C,386,47,225,4,5,0,281
3789,005C,387,51,230,1,3,0,285
3790,005C,388,54,213,2,1,0,270
3791,005C,389,70,195,4,9,0,278
3792,005C,390,59,208,4,4,0,275
3793,005C,391,54,210,4,3,0,271
3794,005C,392,52,217,0,1,0,270
3795,005C,393,46,212,4,9,0,271
3796,005C,394,42,223,2,3,0,270
3797,005C,395,72,206,2,1,0,281
3798,005C,396,54,214,5,7,0,280
3799,005C,397,60,211,0,4,2,277
3800,005C,398,70,184,2,5,0,261
3801,005C,399,54,203,0,5,0,262
3802,005C,400,55,222,2,2,0,281
3803,005C,401,53,228,0,5,0,286
3804,005C,402,57,214,3,7,0,281
3805,005C,403,74,194,3,6,0,277
3806,005C,404,56,220,0,10,0,286
3807,005C,405,49,225,2,4,0,280
3808,005C,406,57,218,2,7,1,285
3809,005C,407,64,201,3,1,0,269
3810,005C,408,65,216,7,1,0,289
3811,005C,409,47,222,3,6,0,278
3812,005C,410,58,209,1,10,0,278
3813,005C,411,68,221,1,5,0,295
3814,005C,412,74,207,2,3,0,286
3815,005C,413,62,210,0,4,0,276
3816,005C,414,50,221,0,5,0,276
3817,005C,415,55,203,5,4,0,267
3818,005C,416,76,192,2,6,0,276
3819,005C,417,61,205,2,6,0,274
3820,005C,418,63,201,2,9,0,275
3821,005C,419,56,225,2,0,0,283
3822,005C,420,66,222,2,4,0,294
3823,005C,421,65,206,2,5,0,278
3824,005C,422,61,209,1,5,0,276
3825,005C,423,63,215,6,6,0,290
3826,005C,424,50,228,2,6,1,287
3827,8,874,52,101,2,8,0,163
3828,8,875,67,92,1,7,0,167
3829,8,876,45,123,0,2,0,170
3830,008B,889,64,198,3,5,0,270
3831,008B,890,53,189,2,6,0,250
3832,008B,891,65,188,6,3,0,262
3833,008B,892,65,178,1,5,0,249
3834,008B,893,64,193,3,3,0,263
3835,008B,894,65,178,6,3,1,253
3836,008B,895,62,192,6,3,0,263
3837,008B,896,54,211,1,3,0,269
3838,008B,897,67,207,3,2,0,279
3839,008B,898,52,225,0,0,0,277
3840,008B,899,57,202,0,5,0,264
3841,008B,900,65,190,4,6,0,265
3842,008B,901,51,209,3,3,0,266
3843,008B,902,63,186,2,3,0,254
3844,008B,903,62,201,9,2,0,274
3845,008B,904,45,209,3,1,0,258
3846,008B,905,43,205,3,6,0,257
3847,008B,906,49,225,4,1,0,279
3848,008B,907,75,177,2,6,0,260
3849,008B,908,74,193,4,4,0,275
3850,008B,909,59,184,2,6,0,251
3851,008B,910,71,165,6,2,0,244
3852,008B,911,75,186,2,8,0,271
3853,008B,912,87,164,1,5,0,257
3854,008B,913,62,185,3,5,0,255
3855,008B,914,51,198,4,8,0,261
3856,008B,915,73,185,1,5,0,264
3857,008B,916,68,207,1,0,0,276
3858,008B,917,48,205,3,1,0,257
3859,008B,918,85,186,4,6,0,281
3860,008B,919,57,190,3,4,0,254
3861,008B,920,58,202,2,2,0,264
3862,008B,921,56,197,1,6,0,260
3863,008B,922,59,185,3,5,0,252
3864,008B,923,74,178,0,7,0,259
3865,008B,924,47,205,4,7,0,263
3866,008B,925,72,183,1,3,0,259
3867,008B,926,64,180,1,7,0,252
3868,008B,927,55,202,6,9,0,272
3869,008B,928,37,223,1,2,0,263
3870,008B,929,73,176,2,8,0,259
3871,008B,930,58,196,9,0,0,263
3872,008B,931,83,171,4,3,0,261
3873,008B,932,65,210,0,3,0,278
3874,008B,933,59,200,3,2,0,264
3875,008B,934,79,162,2,1,0,244
3876,008B,935,77,184,4,2,0,267
3877,008B,936,64,187,2,1,0,254
3878,008B,937,54,210,5,3,0,272
3879,008B,938,48,213,1,5,0,267
3880,008B,939,58,174,2,5,0,239
3881,008B,940,75,191,3,2,0,271
3882,008B,941,75,181,1,3,0,260
3883,008B,942,55,206,3,7,0,271
3884,008B,943,54,194,2,7,0,257
3885,008B,944,57,204,4,3,0,268
3886,008B,945,51,198,3,8,0,260
3887,010E,1305,76,185,0,5,0,266
3888,010E,1306,55,194,3,5,0,257
3889,010E,1307,73,182,1,6,0,262
3890,010E,1308,71,194,2,6,0,273
3891,010E,1309,55,202,1,9,0,267
3892,010E,1310,61,201,0,6,0,268
3893,010E,1311,61,201,2,3,0,267
3894,010E,1312,93,168,5,10,0,276
3895,010E,1313,71,189,2,4,0,266
3896,010E,1314,69,195,4,6,0,274
3897,010E,1315,70,198,0,4,0,272
3898,010E,1316,63,208,1,7,0,279
3899,010E,1317,59,29,3,7,0,98
3900,010E,1318,90,167,3,14,0,274
3901,010E,1319,62,192,2,8,0,264
3902,010E,1320,78,183,0,7,0,268
3903,010E,1321,70,188,2,5,0,265
3904,010E,1322,65,203,1,9,0,278
3905,010E,1323,87,164,5,16,0,272
3906,010E,1324,54,197,2,12,0,265
3907,010E,1325,71,171,1,9,3,255
3908,010E,1326,59,196,2,7,0,264
3909,010E,1327,85,180,2,9,0,276
3910,010E,1328,67,192,2,7,0,268
3911,010E,1329,86,175,1,4,0,266
3912,010E,1330,70,185,7,0,0,262
3913,010E,1331,77,179,1,16,0,273
3914,010E,1332,56,184,4,4,0,248
3915,010E,1333,74,167,1,13,0,255
3916,010E,1334,52,195,9,6,0,262
3917,010E,1335,72,190,2,8,1,273
3918,010E,1336,87,167,1,1,0,256
3919,010E,1337,61,180,3,14,0,258
3920,010E,1338,66,174,1,4,0,245
3921,010E,1339,74,184,2,3,0,263
3922,010E,1340,66,186,1,8,0,261
3923,7,652,30,50,1,1,0,82
3924,011I,1945,88,161,3,7,0,259
3925,011I,1946,116,146,3,12,0,277
3926,011I,1947,90,158,3,6,0,257
3927,011I,1948,85,172,1,4,0,262
3928,011I,1949,87,168,0,6,0,261
3929,011I,1950,86,157,0,5,0,248
3930,011I,1951,104,144,2,6,0,256
3931,011I,1952,100,148,2,5,0,255
3932,011I,1953,91,173,5,3,0,272
3933,011I,1954,102,153,1,5,0,261
3934,011I,1955,90,154,0,9,0,253
3935,011I,1956,109,146,2,4,0,261
3936,011I,1957,85,152,2,7,0,246
3937,011I,1958,98,144,1,5,0,248
3938,011I,1959,92,173,0,5,0,270
3939,011I,1960,92,142,1,5,0,240
3940,011I,1961,89,173,4,4,0,270
3941,011I,1962,102,145,2,9,0,258
3942,011I,1963,87,163,3,4,0,257
3943,011I,1964,85,167,2,9,0,263
3944,011I,1965,98,155,1,2,0,256
3945,011I,1966,137,114,2,2,0,255
3946,011I,1967,100,136,2,5,0,243
3947,011I,1968,102,152,0,7,0,261
3948,011I,1969,110,145,0,7,0,262
3949,011I,1970,97,148,1,3,0,249
3950,011I,1971,107,129,1,2,0,239
3951,011I,1972,103,153,0,8,0,264
3952,011I,1973,95,167,0,6,0,268
3953,011I,1974,111,127,2,7,0,247
3954,011I,1975,85,163,1,2,0,251
3955,011I,1976,95,149,3,6,1,254
3956,011I,1977,83,167,1,2,0,253
3957,011I,1978,83,173,1,11,0,268
3958,011I,1979,89,160,1,7,0,257
3959,011I,1980,101,145,1,4,0,251
3960,011I,1981,117,129,5,7,0,258
3961,011I,1982,85,165,0,3,0,253
3962,011I,1983,87,176,0,3,0,266
3963,011I,1984,89,145,0,11,0,245
3964,011I,1985,103,141,1,7,0,252
3965,011I,1986,104,151,1,5,0,261
3966,011I,1988,69,183,4,7,0,263
3967,010H,1440,54,231,3,1,0,289
3968,010H,1441,59,233,4,1,0,297
3969,010H,1442,74,208,5,3,0,290
3970,010H,1443,57,209,6,10,0,282
3971,010H,1444,49,232,4,1,0,286
3972,010H,1445,58,198,1,6,0,263
3973,010H,1446,63,224,7,1,0,295
3974,010H,1447,59,220,3,6,0,288
3975,010H,1448,61,217,1,2,0,281
3976,010H,1449,68,214,2,7,0,291
3977,010H,1450,73,225,5,4,0,307
3978,010H,1451,61,214,4,7,0,286
3979,010H,1452,67,216,5,4,0,292
3980,010H,1453,58,231,5,1,0,295
3981,010H,1454,70,208,6,1,0,285
3982,010H,1455,66,195,5,2,2,270
3983,010H,1456,61,191,4,5,0,261
3984,010H,1457,69,219,3,3,0,294
3985,010H,1458,70,219,4,3,0,296
3986,010H,1459,47,232,4,3,0,286
3987,010H,1460,47,223,3,4,0,277
3988,010H,1461,79,206,1,7,0,293
3989,010H,1462,83,173,2,16,0,274
3990,010H,1463,40,238,1,9,0,288
3991,010H,1464,50,214,6,6,0,276
3992,010H,1465,48,240,5,2,0,295
3993,010H,1466,65,211,2,6,0,284
3994,010H,1467,59,211,2,4,0,276
3995,010H,1468,69,213,2,4,2,290
3996,010H,1469,65,220,2,7,0,294
3997,010H,1470,81,197,1,6,0,285
3998,010H,1471,60,219,2,4,0,285
3999,010H,1472,66,202,5,8,0,281
4000,010H,1473,68,199,6,2,0,275
4001,010H,1474,58,228,5,5,0,296
4002,010H,1475,53,232,4,2,0,291
4003,014D,2939,40,231,3,5,0,279
4004,014D,2940,34,234,0,0,0,268
4005,014D,2941,38,242,1,2,0,283
4006,014D,2942,36,235,2,1,0,274
4007,014D,2943,35,242,2,0,0,279
4008,014D,2944,25,242,3,1,0,271
4009,014D,2945,42,222,4,0,0,268
4010,014D,2946,39,230,3,1,0,273
4011,014D,2947,27,241,4,0,0,272
4012,014D,2948,33,252,1,2,0,288
4013,014D,2949,33,231,7,1,0,272
4014,014D,2950,35,240,5,1,0,281
4015,014D,2951,33,226,4,4,0,267
4016,014D,2952,51,209,1,1,0,262
4017,014D,2953,38,239,3,2,0,282
4018,014D,2954,30,248,1,0,0,279
4019,014D,2955,28,225,2,3,0,258
4020,014D,2956,34,236,2,1,0,273
4021,014D,2957,36,224,4,4,0,268
4022,014D,2958,29,245,3,1,0,278
4023,010I,1476,61,218,3,1,0,283
4024,010I,1477,75,210,4,2,0,291
4025,010I,1478,64,223,3,11,0,301
4026,010I,1479,51,235,1,2,1,290
4027,010I,1480,63,220,3,9,0,295
4028,010I,1481,72,238,2,3,0,315
4029,010I,1482,74,208,3,4,0,289
4030,010I,1483,45,238,3,3,0,289
4031,010I,1484,53,225,2,1,0,281
4032,010I,1485,59,232,1,2,0,294
4033,010I,1486,78,221,3,4,0,306
4034,010I,1487,71,216,4,3,0,294
4035,010I,1488,54,241,6,5,0,306
4036,010I,1489,54,233,3,6,0,296
4037,010I,1490,51,224,2,6,0,283
4038,010I,1491,57,224,3,4,0,288
4039,010I,1492,63,223,7,4,0,297
4040,010I,1493,66,218,5,4,0,293
4041,010I,1494,49,236,2,2,0,289
4042,010I,1495,52,229,3,4,0,288
4043,010I,1496,68,212,6,2,0,288
4044,010I,1497,61,209,4,6,0,280
4045,010I,1498,66,212,4,4,0,286
4046,010I,1499,51,222,6,3,0,282
4047,010I,1500,58,222,1,2,0,283
4048,010I,1501,70,214,3,2,0,289
4049,010I,1502,65,228,1,4,0,298
4050,010I,1503,61,222,1,1,1,286
4051,010I,1504,70,204,4,7,0,285
4052,004A,181,73,208,1,2,0,284
4053,004A,182,53,224,2,2,0,281
4054,004A,183,51,225,1,5,0,282
4055,004A,184,69,193,4,7,0,273
4056,004A,185,53,205,3,4,0,265
4057,004A,186,62,206,0,2,0,270
4058,004A,187,64,216,2,3,0,285
4059,004A,188,62,215,2,4,0,283
4060,004A,189,50,221,3,4,0,278
4061,004A,190,52,210,4,4,0,270
4062,004A,191,53,228,4,0,0,285
4063,004A,192,51,232,2,1,0,286
4064,004A,193,77,211,3,1,0,292
4065,004A,194,51,216,2,3,0,272
4066,004A,195,57,206,0,4,0,267
4067,004A,196,76,187,1,5,0,269
4068,004A,197,64,197,6,1,0,268
4069,004A,198,56,206,4,3,0,269
4070,004A,199,57,208,4,1,0,270
4071,004A,200,61,215,5,4,0,285
4072,004A,201,66,201,1,2,0,270
4073,004A,202,61,211,6,3,0,281
4074,004A,203,79,194,1,1,0,275
4075,004A,204,52,209,6,2,0,269
4076,004A,205,63,214,0,3,0,280
4077,004A,206,82,188,2,5,0,277
4078,004A,207,52,211,1,4,0,268
4079,004A,208,60,200,5,3,1,269
4080,004A,209,62,210,6,4,0,282
4081,004A,210,58,206,3,4,0,271
4082,004A,211,57,229,1,1,0,288
4083,004A,212,60,211,0,3,0,274
4084,004A,213,60,220,0,4,2,286
4085,004A,214,67,214,1,2,0,284
4086,004A,215,75,189,3,2,0,269
4087,004A,216,59,216,1,3,0,279
4088,004A,217,68,190,4,0,0,262
4089,004A,218,59,213,3,5,0,280
4090,004A,219,48,206,7,7,0,268
4091,004A,220,61,213,3,3,0,280
4092,004A,221,47,227,6,4,0,284
4093,004A,222,72,199,2,6,0,279
4094,004A,223,57,204,3,4,0,268
4095,004A,224,66,208,3,3,0,280
4096,004A,225,62,206,6,6,0,280
4097,004A,226,55,214,1,4,0,274
4098,004A,227,65,200,7,3,0,275
4099,004A,228,68,201,4,3,1,277
4100,004A,229,67,209,5,6,0,287
4101,004A,230,58,218,2,4,0,282
4102,004A,231,53,219,4,4,0,280
4103,011D,1782,56,216,3,3,0,278
4104,011D,1783,60,200,3,6,0,269
4105,011D,1784,45,213,1,8,0,267
4106,011D,1785,42,218,5,5,0,270
4107,011D,1786,49,219,3,5,0,276
4108,011D,1787,58,228,2,2,0,290
4109,011D,1788,36,242,3,4,0,285
4110,011D,1789,78,192,5,5,0,280
4111,011D,1790,61,217,3,4,0,285
4112,011D,1791,50,226,5,4,0,285
4113,011D,1792,59,220,2,2,0,283
4114,011D,1793,64,222,4,5,0,295
4115,011D,1794,69,206,5,6,0,286
4116,011D,1795,44,234,5,2,0,285
4117,011D,1796,79,206,5,1,0,291
4118,011D,1797,72,209,4,3,0,288
4119,011D,1798,64,219,2,5,0,290
4120,011D,1799,69,216,0,6,0,291
4121,011D,1800,50,232,2,5,0,289
4122,011D,1801,58,198,0,4,0,260
4123,011D,1802,48,211,3,13,0,275
4124,011D,1803,66,219,7,6,0,298
4125,011D,1804,48,226,4,4,0,282
4126,011D,1805,63,206,3,2,0,274
4127,011D,1806,70,198,2,19,0,289
4128,011D,1807,59,213,2,4,0,278
4129,011D,1808,53,222,3,5,0,283
4130,011D,1809,70,195,7,9,0,281
4131,011D,1810,46,227,4,1,0,278
4132,011D,1811,57,207,5,4,0,273
4133,011D,1812,71,213,3,4,0,291
4134,011D,1813,63,220,5,2,0,290
4135,011D,1814,64,214,0,0,0,278
4136,011D,1815,54,205,2,3,1,265
4137,011D,1816,64,206,1,4,0,275
4138,011D,1817,64,215,2,2,0,283
4139,011D,1818,54,223,3,4,0,284
4140,010F,1341,70,201,3,4,0,278
4141,010F,1342,60,215,1,3,0,279
4142,010F,1343,58,200,4,12,0,274
4143,010F,1344,71,204,4,7,0,286
4144,010F,1345,47,227,1,1,0,276
4145,010F,1346,71,206,0,1,0,278
4146,010F,1347,77,200,1,8,0,286
4147,010F,1348,59,217,4,6,0,286
4148,010F,1349,64,204,4,4,0,276
4149,010F,1350,58,219,2,0,0,279
4150,010F,1351,83,197,3,7,0,290
4151,010F,1352,73,208,1,2,0,284
4152,010F,1353,55,220,3,5,1,284
4153,010F,1354,58,219,0,3,0,280
4154,010F,1355,52,225,5,3,0,285
4155,010F,1356,75,197,2,5,1,280
4156,010F,1357,73,184,2,3,0,262
4157,010F,1358,57,215,4,6,0,282
4158,010F,1359,61,211,4,3,0,279
4159,010F,1360,74,194,3,6,0,277
4160,010F,1361,63,209,2,2,0,276
4161,010F,1362,57,220,0,8,0,285
4162,010F,1363,61,209,5,5,0,280
4163,010F,1364,72,186,5,3,0,266
4164,010F,1365,73,201,6,1,0,281
4165,010F,1366,84,193,1,2,0,280
4166,010F,1367,58,213,5,5,0,281
4167,010F,1368,73,207,3,7,0,290
4168,010F,1369,59,214,6,7,0,286
4169,010F,1370,50,216,4,2,0,272
4170,010F,1371,66,185,1,7,0,259
4171,010F,1372,52,215,3,5,0,275
4172,010F,1373,51,24,0,9,0,84
4173,010F,1374,57,207,2,7,0,273
4174,010F,1375,70,191,3,8,0,272
4175,010F,1376,63,194,4,3,0,264
4176,010F,1377,78,181,3,11,0,273
4177,011E,1819,70,194,3,3,3,273
4178,011E,1820,76,195,2,9,0,282
4179,011E,1821,67,196,2,3,0,268
4180,011E,1822,69,208,4,4,0,285
4181,011E,1823,64,189,1,14,0,268
4182,011E,1824,61,201,3,5,0,270
4183,011E,1825,61,211,0,4,0,276
4184,011E,1826,74,170,1,17,0,262
4185,011E,1827,80,199,2,5,0,286
4186,011E,1828,78,194,0,6,0,278
4187,011E,1829,60,193,7,7,0,267
4188,011E,1830,60,197,2,7,0,266
4189,011E,1831,60,216,3,3,0,282
4190,011E,1832,56,204,4,9,0,273
4191,011E,1833,50,217,5,5,0,277
4192,011E,1834,60,206,3,5,0,274
4193,011E,1835,56,207,3,7,0,273
4194,011E,1836,67,214,1,9,0,291
4195,011E,1837,74,193,1,2,0,270
4196,011E,1838,66,206,3,4,0,279
4197,011E,1839,64,207,1,5,0,277
4198,011E,1840,60,218,5,0,1,284
4199,011E,1841,50,230,9,0,0,289
4200,011E,1842,55,212,1,7,0,275
4201,011E,1843,70,202,1,8,0,281
4202,011E,1844,52,218,2,5,0,277
4203,011E,1845,66,203,0,4,0,273
4204,011E,1846,70,190,5,9,0,274
4205,011E,1847,68,203,2,3,0,276
4206,011E,1848,59,212,1,1,0,273
4207,011E,1849,68,196,7,7,0,278
4208,011E,1850,70,208,1,2,0,281
4209,011E,1851,71,209,5,0,0,285
4210,011E,1852,71,201,1,2,0,275
4211,011E,1853,59,200,0,10,0,269
4212,011E,1854,55,203,6,4,4,272
4213,011E,1855,60,198,4,4,3,269
4214,011E,1856,78,186,1,4,0,269
4215,011E,1857,73,206,1,6,0,286
4216,011E,1858,45,215,5,3,0,268
4217,011E,1859,57,211,6,5,0,279
4218,011E,1860,47,212,4,7,0,270
4219,011E,1861,62,190,3,11,0,266
4220,011E,1862,63,201,1,4,0,269
4221,011E,1863,56,206,2,4,0,268
4222,011E,1864,59,204,3,6,0,272
4223,12,2092,64,184,0,5,1,254
4224,12,2093,46,210,0,11,0,267
4225,12,2094,72,195,4,2,0,273
4226,12,2095,60,226,1,2,0,289
4227,12,2096,61,209,2,4,0,276
4228,12,2097,68,189,1,6,0,264
4229,12,2098,61,207,1,4,0,273
4230,12,2099,53,208,4,3,0,268
4231,12,2100,72,190,3,8,0,273
4232,12,2101,57,208,0,5,0,270
4233,12,2102,43,222,1,5,0,271
4234,12,2103,59,199,1,9,0,268
4235,12,2104,64,193,3,3,0,263
4236,12,2105,72,191,1,2,0,266
4237,12,2106,81,176,1,4,0,262
4238,12,2107,63,200,1,11,0,275
4239,12,2108,73,171,3,19,0,266
4240,12,2109,58,203,3,3,0,267
4241,12,2110,60,207,4,5,0,276
4242,12,2111,53,225,2,5,0,285
4243,12,2112,54,200,3,3,0,260
4244,12,2113,71,179,3,4,0,257
4245,12,2114,45,218,1,5,0,269
4246,12,2115,79,187,1,2,1,270
4247,12,2116,78,199,2,2,0,281
4248,12,2117,63,194,4,4,0,265
4249,013F,2559,44,221,0,3,0,268
4250,013F,2560,47,230,0,9,0,286
4251,013F,2561,51,231,3,6,0,291
4252,013F,2562,44,242,0,5,0,291
4253,013F,2563,42,249,0,3,0,294
4254,013F,2564,0,0,0,0,0,0
4255,013F,2565,59,218,1,3,0,281
4256,013F,2566,57,213,3,1,0,274
4257,013F,2567,49,229,5,3,0,286
4258,013F,2568,43,226,2,3,0,274
4259,013F,2569,54,209,3,6,0,272
4260,013F,2570,49,216,0,6,0,271
4261,013F,2571,57,210,1,1,0,269
4262,013F,2572,53,234,3,4,0,294
4263,013F,2573,58,214,1,3,0,276
4264,013F,2574,57,205,2,5,0,269
4265,013F,2575,61,218,5,7,0,291
4266,013F,2576,49,228,2,5,0,284
4267,013F,2577,50,230,2,3,0,285
4268,013F,2578,55,219,1,10,0,285
4269,013F,2579,58,209,1,0,0,268
4270,013F,2580,55,222,0,6,0,283
4271,013F,2581,56,224,3,2,0,285
4272,005F,469,109,150,5,9,0,273
4273,005F,470,125,148,8,4,0,285
4274,005F,471,110,139,2,8,0,259
4275,005F,472,128,129,1,4,0,262
4276,005F,473,112,143,2,10,0,267
4277,005F,474,101,178,2,4,0,285
4278,005F,475,124,129,2,9,0,264
4279,005F,476,139,126,6,10,0,281
4280,005F,477,127,128,0,20,0,275
4281,005F,478,143,129,2,6,0,280
4282,005F,479,119,139,0,7,0,265
4283,005F,480,110,133,1,5,0,249
4284,005F,481,115,157,2,4,0,278
4285,005G,482,55,194,4,4,0,257
4286,005G,483,60,218,4,1,0,283
4287,005G,484,51,210,4,4,0,269
4288,005G,485,52,202,2,1,0,257
4289,005G,486,66,192,2,1,0,261
4290,005G,487,45,212,6,5,0,268
4291,005G,488,61,176,4,16,0,257
4292,005G,489,54,191,5,4,1,255
4293,005G,490,67,200,6,4,0,277
4294,005G,491,57,204,0,3,0,264
4295,005G,492,61,205,2,7,0,275
4296,005G,493,58,196,4,4,0,262
4297,005G,494,56,205,1,3,0,265
4298,005G,495,62,196,0,4,2,264
4299,005G,496,57,205,2,9,0,273
4300,005G,497,39,213,0,6,1,259
4301,005G,498,67,200,5,2,1,275
4302,005G,499,62,204,6,3,0,275
4303,005G,500,74,174,5,5,0,258
4304,005G,501,66,192,6,8,0,272
4305,005G,502,64,197,0,3,1,265
4306,005G,503,49,195,1,5,0,250
4307,005G,504,49,202,5,5,0,261
4308,005G,505,69,186,1,7,0,263
4309,005G,506,66,203,2,7,0,278
4310,005G,507,48,211,3,4,0,266
4311,005G,508,59,196,2,4,0,261
4312,005G,509,62,187,5,7,0,261
4313,005G,510,63,190,4,6,0,263
4314,005G,511,62,197,8,3,0,270
4315,005G,512,74,197,4,4,0,279
4316,005G,513,52,190,11,3,0,256
4317,005G,514,56,216,2,4,0,278
4318,005G,515,62,199,3,5,0,269
4319,005G,516,57,186,1,4,0,248
4320,005G,517,57,195,4,5,0,261
4321,005G,518,66,189,4,2,0,261
4322,005G,519,74,184,0,6,0,264
4323,005G,520,66,193,3,7,0,269
4324,005G,521,61,199,2,3,0,265
4325,005G,522,66,192,1,8,0,267
4326,005G,523,65,178,2,6,0,251
4327,005G,524,47,213,4,3,0,267
4328,005G,525,74,179,3,4,0,260
4329,005G,526,77,180,5,3,0,265
4330,005G,527,43,207,6,9,0,265
4331,013J,2704,71,196,4,3,0,274
4332,013J,2705,71,181,3,3,0,258
4333,013J,2706,66,192,2,3,0,263
4334,013J,2707,87,164,1,6,0,258
4335,013J,2708,71,211,1,0,0,283
4336,013J,2709,69,195,1,6,0,271
4337,013J,2710,61,200,4,8,0,273
4338,013J,2711,69,169,3,0,0,241
4339,013J,2712,65,193,3,4,0,265
4340,013J,2713,59,191,4,5,0,259
4341,013J,2714,67,208,1,4,0,280
4342,013J,2715,46,198,1,12,0,257
4343,013J,2716,60,184,2,12,6,264
4344,013J,2717,71,169,1,5,0,246
4345,013J,2718,63,187,3,4,0,257
4346,013J,2719,59,185,4,6,0,254
4347,013J,2720,65,205,0,2,1,273
4348,013J,2721,56,193,0,4,0,253
4349,013J,2722,65,186,4,5,0,260
4350,013J,2723,69,192,1,4,0,266
4351,013J,2724,68,182,2,11,0,263
4352,013J,2725,86,174,3,3,0,266
4353,013J,2726,75,188,0,3,0,266
4354,013J,2727,75,178,4,4,0,261
4355,013J,2728,62,179,2,5,0,248
4356,013J,2729,52,217,2,11,0,282
4357,013J,2730,87,184,2,1,0,274
4358,013J,2731,59,200,1,13,0,273
4359,013J,2732,88,173,1,9,0,271
4360,013J,2733,67,187,2,7,2,265
4361,013J,2734,72,187,1,3,0,263
4362,013J,2735,66,205,1,5,0,277
4363,013J,2736,50,210,5,2,0,267
4364,013J,2737,67,202,1,2,0,272
4365,013J,2738,67,202,1,8,0,278
4366,013J,2739,69,185,4,10,0,268
4367,013J,2740,74,172,3,3,0,252
4368,013J,2741,56,207,1,7,0,271
4369,013J,2742,66,178,4,10,0,258
4370,013J,2743,88,159,1,1,0,249
4371,013J,2744,72,185,1,3,0,261
4372,013J,2745,80,176,2,4,0,262
4373,013J,2746,55,207,5,9,0,276
4374,013J,2747,61,194,4,6,0,265
4375,013J,2748,62,191,2,6,0,261
4376,013J,2749,78,173,3,8,0,262
4377,013J,2750,65,200,1,8,0,274
4378,013J,2751,67,195,4,3,0,269
4379,013J,2752,79,175,0,5,0,259
4380,013J,2753,63,209,2,3,0,277
4381,013J,2754,66,178,6,11,0,261
4382,013J,2755,74,180,3,1,0,258
4383,013J,2756,49,214,6,4,0,273
4384,013J,2757,88,174,2,3,0,267
4385,013J,2758,68,190,5,6,0,269
4386,013J,2759,69,184,2,5,0,260
4387,013J,2760,78,183,1,3,0,265
4388,013J,2761,60,198,3,0,0,261
4389,013J,2762,63,192,3,4,0,262
4390,013J,2763,75,182,1,3,0,261
4391,013J,2764,79,196,1,4,0,280
4392,013J,2765,55,208,4,0,0,267
4393,013J,2766,81,161,3,6,0,251
4394,013J,2767,75,185,4,6,0,270
4395,013J,2768,59,209,4,6,0,278
4396,013J,2769,73,192,2,5,0,272
4397,013J,2770,77,170,5,7,0,259
4398,013J,2771,55,199,3,2,0,259
4399,013J,2772,70,196,3,3,0,272
4400,013J,2773,63,185,1,5,0,254
4401,013J,2774,59,200,0,4,0,263
4402,013J,2775,77,184,1,10,0,272
4403,013J,2776,63,188,4,1,0,256
4404,013J,2777,72,196,0,5,0,273
4405,013J,2778,68,182,5,6,0,261
4406,013J,2779,64,195,2,3,0,264
4407,013J,2780,67,188,3,4,0,262
4408,013J,2781,85,167,5,2,0,259
4409,013J,2782,74,176,0,4,0,254
4410,013J,2783,91,176,2,2,0,271
4411,013J,2784,82,177,2,3,0,264
4412,013J,2785,68,195,2,3,0,268
4413,013J,2786,74,182,2,13,0,271
4414,013J,2787,81,174,5,5,0,265
4415,013J,2788,79,171,0,3,0,253
4416,013J,2789,76,202,3,4,0,285
4417,013J,2790,83,173,1,3,0,260
4418,013J,2791,55,190,3,0,0,248
4419,013J,2792,69,190,2,3,0,264
4420,013J,2793,75,187,2,1,0,265
4421,013J,2794,65,209,2,1,0,277
4422,007F,814,55,196,2,6,0,259
4423,007F,815,84,176,1,2,0,263
4424,007F,816,64,216,1,4,0,285
4425,007F,817,60,207,5,6,0,278
4426,007F,818,50,223,3,6,0,282
4427,007F,819,66,221,2,4,0,293
4428,007F,820,57,215,4,2,0,278
4429,007F,821,70,201,3,5,0,279
4430,007F,822,69,199,0,9,0,277
4431,007F,823,79,191,2,4,0,276
4432,007F,824,56,206,0,4,0,266
4433,007F,825,64,188,2,5,0,259
4434,007F,826,58,218,4,1,0,281
4435,007F,827,60,216,4,4,0,284
4436,007F,828,78,191,2,1,0,272
4437,007F,829,66,211,2,3,0,282
4438,007F,830,54,222,1,6,0,283
4439,007F,831,67,211,3,4,0,285
4440,007F,832,67,203,1,6,0,277
4441,007F,833,58,209,2,6,0,275
4442,007F,834,70,198,2,1,0,271
4443,007F,835,50,211,4,4,0,269
4444,007F,836,79,190,5,3,0,277
4445,007F,837,57,203,1,3,0,264
4446,011B,1719,54,197,3,4,0,258
4447,011B,1720,37,220,0,8,0,265
4448,011B,1721,67,203,0,2,0,272
4449,011B,1722,44,212,3,2,0,261
4450,011B,1723,60,206,1,1,0,268
4451,011B,1724,38,232,6,0,0,276
4452,011B,1725,55,213,3,2,0,273
4453,011B,1726,59,194,2,4,0,259
4454,011B,1727,63,209,1,5,0,278
4455,011B,1728,49,200,4,1,0,254
4456,011B,1729,51,206,1,3,0,261
4457,011B,1730,53,209,3,3,0,268
4458,011B,1731,58,189,1,2,0,250
4459,011B,1732,53,196,2,7,0,258
4460,011B,1733,39,213,5,5,0,262
4461,011B,1734,37,208,2,7,0,254
4462,011B,1735,60,194,2,3,0,259
4463,011B,1736,56,192,6,3,0,257
4464,011B,1737,55,216,5,4,1,281
4465,011B,1738,46,220,2,4,0,272
4466,007E,767,63,204,2,4,1,274
4467,007E,768,74,202,6,3,0,285
4468,007E,769,69,215,5,9,0,298
4469,007E,770,72,219,3,2,0,296
4470,007E,771,60,202,9,6,0,277
4471,007E,772,44,227,4,6,0,281
4472,007E,773,65,221,1,2,0,289
4473,007E,774,65,220,4,5,0,294
4474,007E,775,65,216,4,5,0,290
4475,007E,776,72,182,1,1,0,256
4476,007E,777,50,225,4,5,0,284
4477,007E,778,66,203,3,6,0,278
4478,007E,779,73,196,4,5,0,278
4479,007E,780,68,210,2,0,0,280
4480,007E,781,56,205,5,11,0,277
4481,007E,782,58,224,1,8,0,291
4482,007E,783,62,197,11,0,0,270
4483,007E,784,62,217,1,4,0,284
4484,007E,785,73,195,1,6,0,275
4485,007E,786,57,207,4,8,1,277
4486,007E,787,52,205,3,4,0,264
4487,007E,788,83,193,8,8,0,292
4488,007E,789,62,222,4,3,0,291
4489,007E,790,72,195,9,5,0,281
4490,007E,791,69,220,5,3,0,297
4491,007E,792,68,202,1,5,0,276
4492,007E,793,63,197,4,5,3,272
4493,007E,794,74,195,4,4,0,277
4494,007E,795,74,186,2,3,0,265
4495,007E,796,68,209,8,2,0,287
4496,007E,797,57,213,8,8,0,286
4497,007E,798,75,208,5,4,0,292
4498,007E,799,65,200,0,7,0,272
4499,007E,800,72,230,2,5,0,309
4500,007E,801,76,206,1,6,0,289
4501,007E,802,80,196,2,4,0,282
4502,007E,803,81,202,3,2,0,288
4503,007E,804,66,193,1,3,0,263
4504,007E,805,54,218,6,6,0,284
4505,007E,806,62,219,5,2,0,288
4506,007E,807,59,214,7,3,0,283
4507,007E,808,69,197,7,8,0,281
4508,007E,809,57,211,5,6,0,279
4509,007E,810,77,191,2,3,0,273
4510,007E,811,80,195,5,3,0,283
4511,007E,812,67,196,4,12,0,279
4512,007E,813,69,210,2,2,0,283
4513,012D,2215,85,161,5,0,0,251
4514,012D,2216,0,0,0,0,0,0
4515,012D,2217,94,189,0,0,0,283
4516,012D,2218,83,174,3,7,0,267
4517,012D,2219,68,185,4,6,0,263
4518,012D,2220,79,177,1,6,0,263
4519,012D,2221,76,179,3,7,0,265
4520,012D,2222,85,187,2,1,0,275
4521,012D,2223,58,207,0,8,0,273
4522,012D,2224,69,195,4,7,0,275
4523,012D,2225,84,180,0,11,0,275
4524,012D,2226,83,171,4,8,0,266
4525,012D,2227,81,184,4,0,0,269
4526,012D,2228,81,173,4,5,0,263
4527,012D,2229,58,203,8,7,0,276
4528,012D,2230,73,189,1,2,0,265
4529,012D,2231,72,190,2,5,0,269
4530,012D,2232,75,192,2,4,0,273
4531,012D,2233,83,180,1,4,0,268
4532,012D,2234,80,187,4,3,0,274
4533,012D,2235,77,177,4,10,0,268
4534,012D,2236,78,201,2,5,0,286
4535,012D,2237,80,178,5,9,0,272
4536,012D,2238,69,186,19,0,0,274
4537,012D,2239,78,167,2,5,0,252
4538,012D,2240,78,192,1,5,0,276
4539,012D,2241,80,191,1,3,0,275
4540,012D,2242,76,169,2,7,0,254
4541,012D,2243,72,191,1,7,0,271
4542,012D,2244,85,194,3,5,0,287
4543,012D,2245,91,176,0,5,0,272
4544,012D,2246,86,170,3,10,0,269
4545,012D,2247,86,182,2,4,0,274
4546,012D,2248,80,189,0,5,0,274
4547,012D,2249,73,186,1,12,0,272
4548,012D,2250,85,174,2,2,0,263
4549,012D,2251,76,193,1,7,0,277
4550,012D,2252,53,207,5,7,0,272
4551,012D,2253,90,190,1,5,0,286
4552,012D,2254,77,177,0,4,0,258
4553,012D,2255,76,181,2,9,0,268
4554,012D,2256,66,201,5,4,0,276
4555,012D,2257,77,177,3,2,0,259
4556,012D,2258,77,180,2,5,0,264
4557,012D,2259,74,170,2,9,0,255
4558,012D,2260,75,191,6,0,0,272
4559,012D,2261,66,177,6,7,0,256
4560,012D,2262,73,173,0,5,0,251
4561,012D,2263,72,181,1,1,1,256
4562,012D,2264,72,169,2,13,0,256
4563,012D,2265,75,183,1,8,0,267
4564,012D,2266,73,186,2,1,0,262
4565,012D,2267,74,186,0,2,0,262
4566,012D,2268,75,202,2,1,0,280
4567,012D,2269,65,195,2,9,0,271
4568,012D,2270,72,194,4,8,0,278
4569,012D,2271,74,187,1,5,1,268
4570,012D,2272,68,191,4,8,0,271
4571,012D,2273,65,185,3,14,0,267
4572,012D,2274,68,187,2,6,0,263
4573,012D,2275,87,172,2,4,1,266
4574,012D,2276,81,184,1,5,0,271
4575,012D,2277,86,168,3,5,0,262
4576,012D,2278,67,183,0,8,0,258
4577,012D,2279,76,204,1,3,0,284
4578,012D,2280,77,184,3,4,0,268
4579,012D,2281,84,195,5,5,0,289
4580,012D,2282,88,175,6,6,0,275
4581,012D,2283,89,172,2,6,0,269
4582,012D,2284,76,198,2,3,0,279
4583,012D,2285,78,183,3,4,0,268
4584,012D,2286,73,197,3,10,0,283
4585,012D,2287,72,182,3,5,0,262
4586,012D,2288,68,193,3,6,0,270
4587,014P,3169,84,194,5,6,0,289
4588,014P,3170,69,199,1,8,0,277
4589,014P,3171,103,172,2,8,0,285
4590,014P,3172,73,194,7,4,0,278
4591,014P,3173,81,205,3,7,0,296
4592,014P,3174,84,178,1,10,1,274
4593,014P,3175,70,199,6,4,0,279
4594,014P,3176,88,182,3,4,0,277
4595,014P,3177,80,192,4,3,0,279
4596,014P,3178,81,195,5,4,0,285
4597,014P,3179,74,197,6,2,0,279
4598,008A,877,84,182,2,6,0,274
4599,008A,878,61,213,2,5,0,281
4600,008A,879,83,172,0,4,0,259
4601,008A,880,78,164,4,1,0,247
4602,008A,881,55,197,2,2,0,256
4603,008A,882,63,200,3,2,0,268
4604,008A,883,73,200,0,2,0,275
4605,008A,884,65,182,3,6,0,256
4606,008A,885,64,196,0,2,0,262
4607,008A,886,88,168,2,5,0,263
4608,008A,887,84,181,1,2,0,268
4609,008A,888,52,209,1,4,0,266
4610,014E,2959,72,211,1,5,0,289
4611,014E,2960,53,228,3,10,0,294
4612,014E,2961,56,232,3,1,0,292
4613,014E,2962,63,210,0,1,0,274
4614,014E,2963,66,212,3,4,0,285
4615,014E,2964,60,209,2,0,3,274
4616,014E,2965,64,215,1,5,0,285
4617,014E,2966,59,223,3,2,0,287
4618,014E,2967,54,227,0,6,0,287
4619,014E,2968,65,215,2,5,0,287
4620,014E,2969,58,200,1,10,0,269
4621,014E,2970,60,202,3,4,0,269
4622,014E,2971,81,194,3,3,0,281
4623,014E,2972,91,197,2,5,0,295
4624,014E,2973,62,224,1,10,0,297
4625,014E,2974,47,219,2,3,0,271
4626,014E,2975,65,204,2,6,0,277
4627,014E,2976,75,210,3,9,0,297
4628,014E,2977,71,200,1,4,0,276
4629,012A,2118,94,180,1,9,0,284
4630,012A,2119,76,191,2,13,1,283
4631,012A,2120,87,175,5,5,0,272
4632,012A,2121,74,188,5,10,0,277
4633,012A,2122,87,171,2,10,0,270
4634,012A,2123,91,175,3,3,0,272
4635,012A,2124,75,184,5,5,0,269
4636,012A,2125,81,186,6,4,0,277
4637,012A,2126,87,186,2,9,0,284
4638,012A,2127,93,176,0,5,1,275
4639,012A,2128,94,171,3,13,3,284
4640,012A,2129,110,166,2,8,0,286
4641,012A,2130,85,175,2,5,0,267
4642,012A,2131,96,186,3,6,0,291
4643,012A,2132,87,188,0,0,0,275
4644,012A,2133,83,186,3,6,0,278
4645,013D,2547,65,184,3,7,0,259
4646,013D,2548,63,179,5,7,0,254
4647,013D,2549,70,195,0,0,0,265
4648,013D,2550,72,176,3,14,0,265
4649,013D,2551,67,183,1,9,0,260
4650,013D,2552,61,200,1,6,0,268
4651,013D,2553,70,176,2,22,0,270
4652,013D,2554,73,172,2,5,0,252
4653,011G,1887,87,183,2,6,0,278
4654,011G,1888,97,162,3,3,3,268
4655,011G,1889,79,192,1,7,0,279
4656,011G,1890,77,172,3,3,0,255
4657,011G,1891,94,174,2,5,0,275
4658,011G,1892,94,167,2,7,0,270
4659,011G,1893,68,223,1,4,0,296
4660,011G,1894,58,200,0,6,0,264
4661,011G,1895,59,198,6,5,0,268
4662,011G,1896,81,187,1,8,0,277
4663,011G,1897,72,199,1,3,0,275
4664,011G,1898,81,189,2,1,0,273
4665,011G,1899,72,202,2,3,0,279
4666,011G,1900,61,209,4,2,0,276
4667,011G,1901,97,166,1,7,1,272
4668,011G,1902,76,191,3,7,0,277
4669,011G,1903,76,181,5,6,0,268
4670,011G,1904,79,190,1,3,0,273
4671,011G,1905,68,192,3,8,0,271
4672,011G,1906,66,187,3,10,0,266
4673,011G,1907,52,199,3,3,0,257
4674,011G,1908,89,163,0,9,1,262
4675,011G,1909,96,164,1,6,0,267
4676,011G,1910,78,189,0,1,2,270
4677,011G,1911,88,187,2,3,0,280
4678,011G,1912,89,186,1,3,0,279
4679,011G,1913,93,183,2,5,0,283
4680,011G,1914,67,202,2,9,0,280
4681,011G,1915,77,189,4,1,0,271
4682,011G,1916,89,168,0,5,0,262
4683,011G,1917,92,184,1,0,0,277
4684,011G,1918,87,169,2,3,0,261
4685,011G,1919,78,172,2,12,0,264
4686,011G,1920,78,188,2,1,3,272
4687,011G,1921,110,156,2,2,0,270
4688,011G,1922,68,185,2,7,13,275
4689,011G,1923,62,195,2,2,0,261
4690,011G,1924,78,176,1,7,0,262
4691,005A,351,98,154,2,4,0,258
4692,005A,352,103,150,0,4,0,257
4693,005A,353,91,160,3,1,0,255
4694,005A,354,73,147,5,8,0,233
4695,005A,355,92,166,0,5,0,263
4696,005A,356,76,163,4,9,0,252
4697,005A,357,68,181,4,6,0,259
4698,005A,358,83,155,4,4,0,246
4699,005A,359,95,153,4,1,0,253
4700,005A,360,90,150,3,9,1,253
4701,005A,361,88,158,2,4,0,252
4702,005A,362,72,184,2,4,0,262
4703,005A,363,96,153,2,4,0,255
4704,005A,364,72,156,6,11,0,245
4705,005A,365,97,155,2,3,0,257
4706,005A,366,90,163,4,7,0,264
4707,013I,2686,87,177,3,3,0,270
4708,013I,2687,86,181,4,6,0,277
4709,013I,2688,71,180,3,7,0,261
4710,013I,2689,57,189,7,4,0,257
4711,013I,2690,85,170,3,6,0,264
4712,013I,2691,73,200,2,12,0,287
4713,013I,2692,92,190,0,5,0,287
4714,013I,2693,81,180,1,1,0,263
4715,013I,2694,82,168,1,6,0,257
4716,013I,2695,62,200,2,9,0,273
4717,013I,2696,84,173,2,9,0,268
4718,013I,2697,94,177,0,5,0,276
4719,013I,2698,89,185,1,0,0,275
4720,013I,2699,90,186,0,0,0,276
4721,013I,2700,93,172,1,4,0,270
4722,013I,2701,84,187,3,7,1,282
4723,013I,2702,86,182,1,6,0,275
4724,013I,2703,78,186,6,3,0,273
4725,4,122,53,197,2,2,0,254
4726,4,123,54,203,2,4,0,263
4727,4,124,42,213,5,4,0,264
4728,4,125,63,205,4,5,0,277
4729,4,126,56,205,3,1,0,265
4730,4,127,74,192,3,0,0,269
4731,4,128,52,204,4,6,0,266
4732,4,129,48,225,2,4,0,279
4733,4,130,62,203,3,1,0,269
4734,4,131,63,197,2,2,0,264
4735,4,132,46,200,3,6,0,255
4736,4,133,65,201,3,0,0,269
4737,4,134,65,193,6,4,0,268
4738,4,135,50,217,8,3,0,278
4739,4,136,60,206,4,3,0,273
4740,4,137,41,215,7,3,0,266
4741,4,138,48,208,3,1,0,260
4742,4,139,50,199,5,4,0,258
4743,4,140,61,189,4,3,2,259
4744,4,141,55,203,4,0,0,262
4745,4,142,62,197,4,1,0,264
4746,4,143,63,199,3,1,0,266
4747,4,144,63,193,4,3,0,263
4748,4,145,60,195,4,1,0,260
4749,4,146,50,195,6,1,0,252
4750,4,147,66,186,2,5,0,259
4751,4,148,61,180,5,0,0,246
4752,4,149,62,191,2,6,0,261
4753,4,150,55,188,8,1,0,252
4754,4,151,57,198,4,2,0,261
4755,4,152,60,202,3,7,0,272
4756,4,153,51,200,5,2,0,258
4757,4,154,54,196,6,1,0,257
4758,4,155,52,198,3,1,1,255
4759,4,156,47,213,4,3,0,267
4760,4,157,65,196,2,2,0,265
4761,4,158,57,208,10,6,0,281
4762,4,159,61,204,2,3,3,273
4763,4,160,68,186,8,1,1,264
4764,4,161,58,211,4,0,0,273
4765,4,162,67,194,8,0,0,269
4766,4,163,50,201,4,2,0,257
4767,4,164,52,213,5,2,0,272
4768,4,165,58,215,2,6,0,281
4769,4,166,58,204,2,6,0,270
4770,4,167,46,205,6,3,1,261
4771,4,168,46,218,3,3,0,270
4772,4,169,62,199,8,4,0,273
4773,4,170,63,200,1,1,0,265
4774,4,171,60,200,3,4,0,267
4775,4,172,64,190,4,2,0,260
4776,4,173,64,200,4,4,0,272
4777,4,174,63,177,3,3,0,246
4778,4,175,76,179,3,1,0,259
4779,4,176,70,195,1,3,0,269
4780,4,177,68,185,5,5,0,263
4781,4,178,67,201,2,6,0,276
4782,4,179,49,197,1,2,0,249
4783,4,180,57,206,0,3,0,266
4784,14,2832,41,228,6,3,1,279
4785,14,2833,44,232,2,2,0,280
4786,14,2834,45,227,0,1,0,273
4787,14,2835,31,241,2,1,0,275
4788,14,2836,42,225,3,0,0,270
4789,14,2837,32,248,2,1,0,283
4790,14,2838,58,223,1,1,0,283
4791,14,2839,27,243,7,0,0,277
4792,14,2840,29,255,1,5,0,290
4793,14,2841,57,223,1,0,2,283
4794,14,2842,47,223,2,4,0,276
4795,14,2843,42,228,4,1,0,275
4796,14,2844,52,232,3,1,0,288
4797,14,2845,42,227,3,3,0,275
4798,14,2846,47,226,3,1,0,277
4799,14,2847,34,238,3,2,0,277
4800,14,2848,44,238,5,1,0,288
4801,14,2849,48,226,0,3,0,277
4802,14,2850,46,242,1,0,0,289
4803,14,2851,56,232,2,0,0,290
4804,010K,1541,73,192,2,7,0,274
4805,010K,1542,88,169,2,7,0,266
4806,010K,1543,66,209,1,2,0,278
4807,010K,1544,64,213,2,5,0,284
4808,010K,1545,83,188,2,5,0,278
4809,010K,1546,62,201,2,5,0,270
4810,010K,1547,78,182,3,6,0,269
4811,010K,1548,88,189,2,3,0,282
4812,010K,1549,65,216,4,2,0,287
4813,010K,1550,75,195,2,3,0,275
4814,010K,1551,79,188,1,4,0,272
4815,010K,1552,73,190,0,6,0,269
4816,010K,1553,65,190,2,11,0,268
4817,010K,1554,78,182,1,10,0,271
4818,010K,1555,85,198,2,2,0,287
4819,012C,2201,71,176,2,8,0,257
4820,012C,2202,89,176,10,0,0,275
4821,012C,2203,62,184,3,6,0,255
4822,012C,2204,65,186,2,0,0,253
4823,012C,2205,61,187,0,4,0,252
4824,012C,2206,53,194,7,0,0,254
4825,012C,2207,65,179,1,8,0,253
4826,012C,2208,82,175,4,0,0,261
4827,012C,2209,66,191,0,7,0,264
4828,012C,2210,57,206,3,8,0,274
4829,012C,2211,69,189,11,0,0,269
4830,012C,2212,79,174,2,3,0,258
4831,012C,2213,71,176,1,12,0,260
4832,012C,2214,69,191,3,11,0,274
4833,004F,304,132,112,3,6,0,253
4834,004F,305,136,115,1,2,0,254
4835,004F,306,127,118,2,6,2,255
4836,004F,307,122,131,2,7,2,264
4837,004F,308,132,120,6,8,0,266
4838,004F,309,111,125,3,2,0,241
4839,004F,310,117,133,3,8,0,261
4840,012G,2360,65,204,1,12,0,282
4841,012G,2361,60,217,1,3,0,281
4842,012G,2362,66,197,2,8,1,274
4843,012G,2363,58,213,2,6,0,279
4844,012G,2364,82,180,6,4,0,272
4845,012G,2365,72,204,4,9,0,289
4846,012G,2366,80,185,1,13,0,279
4847,012G,2367,62,208,1,15,0,286
4848,012G,2368,60,219,1,3,0,283
4849,012G,2369,61,218,1,3,0,283
4850,012G,2370,0,0,1,7,0,8
4851,012G,2371,64,213,4,5,0,286
4852,012G,2372,60,225,3,3,0,291
4853,012G,2373,56,219,0,10,0,285
4854,012G,2374,70,212,2,8,0,292
4855,012G,2375,79,205,4,5,0,293
4856,012G,2376,55,226,3,6,0,290
4857,012G,2377,63,206,3,12,0,284
4858,012G,2378,66,192,7,3,0,268
4859,012G,2379,58,208,2,2,0,270
4860,012G,2380,74,209,4,2,0,289
4861,012G,2381,78,211,4,2,0,295
4862,012G,2382,62,191,3,9,0,265
4863,012G,2383,50,221,3,4,0,278
4864,012G,2384,78,186,1,6,0,271
4865,012G,2385,0,195,0,3,0,198
4866,012G,2386,69,193,3,6,0,271
4867,012G,2387,76,192,1,3,0,272
4868,012G,2388,59,205,3,8,0,275
4869,012G,2389,70,209,3,2,0,284
4870,012G,2390,64,213,2,6,0,285
4871,004B,232,68,202,2,4,0,276
4872,004B,233,43,213,5,7,0,268
4873,004B,234,70,207,3,1,0,281
4874,004B,235,58,212,2,2,0,274
4875,004B,236,55,220,5,3,0,283
4876,004B,237,42,232,6,4,0,284
4877,004B,238,56,198,1,9,0,264
4878,004B,239,55,219,4,1,0,279
4879,004B,240,62,204,8,2,1,277
4880,004B,241,50,224,1,2,0,277
4881,004B,242,64,212,3,2,0,281
4882,004B,243,54,217,1,2,0,274
4883,004B,244,55,230,7,2,0,294
4884,004B,245,57,217,4,1,0,279
4885,004B,246,59,213,5,0,0,277
4886,004B,247,49,221,1,7,0,278
4887,004B,248,40,221,9,2,0,272
4888,004B,249,50,215,9,1,0,275
4889,004B,250,59,204,5,1,0,269
4890,004B,251,55,212,1,1,0,269
4891,004B,252,66,198,1,5,0,270
4892,004B,253,46,217,3,3,0,269
4893,004B,254,65,199,6,4,0,274
4894,004B,255,61,212,4,6,0,283
4895,004B,256,45,219,1,5,0,270
4896,004B,257,49,226,4,4,0,283
4897,004B,258,45,230,8,1,0,284
4898,004B,259,55,217,4,5,0,281
4899,004B,260,57,212,5,7,0,281
4900,004B,261,43,223,3,3,0,272
4901,004B,262,63,198,2,9,0,272
4902,004B,263,64,209,3,6,0,282
4903,004B,264,62,203,4,2,0,271
4904,004B,265,52,206,5,5,0,268
4905,004B,266,48,208,3,3,0,262
4906,004B,267,63,209,4,7,0,283
4907,004B,268,49,221,7,4,2,283
4908,004B,269,52,206,5,4,0,267
4909,004B,270,49,224,2,3,0,278
4910,004B,271,43,232,4,3,0,282
4911,004B,272,57,227,4,5,0,293
4912,004B,273,37,246,0,0,0,283
4913,004B,274,71,201,1,5,0,278
4914,004B,275,65,195,3,7,0,270
4915,004B,276,45,206,4,12,0,267
4916,004B,277,51,225,4,5,0,285
4917,014O,3147,79,170,1,4,0,254
4918,014O,3148,82,175,5,6,0,268
4919,014O,3149,89,173,3,7,0,272
4920,014O,3150,100,154,0,3,0,257
4921,014O,3151,64,168,5,5,0,242
4922,014O,3152,70,180,4,5,0,259
4923,014O,3153,60,186,1,4,0,251
4924,014O,3154,81,173,2,5,0,261
4925,014O,3155,82,177,0,5,0,264
4926,014O,3156,79,171,2,4,0,256
4927,014O,3157,0,0,3,5,0,8
4928,014O,3158,73,184,2,6,0,265
4929,014O,3159,60,193,1,5,0,259
4930,014O,3160,73,175,1,1,0,250
4931,014O,3161,79,182,6,0,0,267
4932,014O,3162,81,171,1,6,0,259
4933,014O,3163,84,175,0,9,0,268
4934,014O,3164,60,193,2,0,1,256
4935,014O,3165,86,161,2,10,0,259
4936,014O,3166,58,204,0,2,0,264
4937,014O,3167,81,179,3,2,1,266
4938,014O,3168,72,173,0,0,8,253
4939,012H,2391,70,196,4,4,0,274
4940,012H,2392,71,210,2,1,0,284
4941,012H,2393,59,223,4,3,0,289
4942,012H,2394,55,229,6,1,0,291
4943,012H,2395,65,206,6,0,0,277
4944,012H,2396,64,204,1,6,0,275
4945,012H,2397,67,206,3,5,0,281
4946,012H,2398,90,189,0,1,0,280
4947,012H,2399,71,221,3,1,0,296
4948,012H,2400,56,203,2,2,0,263
4949,012H,2401,53,208,5,8,0,274
4950,012H,2402,63,198,3,9,0,273
4951,012H,2403,61,203,1,9,0,274
4952,012H,2404,58,221,5,6,0,290
4953,012H,2405,67,202,4,6,0,279
4954,012H,2406,67,198,4,1,0,270
4955,012H,2407,64,199,3,2,0,268
4956,012H,2408,47,225,0,2,0,274
4957,012H,2409,73,200,0,6,0,279
4958,012H,2410,56,196,1,5,0,258
4959,012H,2411,61,198,0,5,0,264
4960,012H,2412,58,211,0,5,1,275
4961,012H,2413,71,210,0,4,0,285
4962,012H,2414,58,203,3,3,1,268
4963,012H,2415,49,228,0,6,0,283
4964,012H,2416,67,199,3,3,0,272
4965,012H,2417,72,215,2,6,0,295
4966,012H,2418,71,205,1,0,0,277
4967,012H,2419,63,199,1,4,0,267
4968,012H,2420,66,220,0,3,0,289
4969,012H,2421,72,198,2,4,0,276
4970,9,971,64,197,4,4,0,269
4971,9,972,67,196,6,1,0,270
4972,9,973,55,208,5,3,0,271
4973,9,974,45,219,4,0,0,268
4974,9,975,42,215,4,3,0,264
4975,9,976,57,194,8,6,0,265
4976,9,977,58,206,5,2,0,271
4977,9,978,49,205,4,3,0,261
4978,9,979,62,195,6,2,0,265
4979,9,980,72,197,4,2,0,275
4980,9,981,43,220,5,0,0,268
4981,9,982,47,218,16,0,0,281
4982,9,983,59,191,5,6,0,261
4983,9,984,53,207,3,2,0,265
4984,9,985,60,208,2,4,0,274
4985,9,986,51,207,3,2,0,263
4986,9,987,63,195,2,1,0,261
4987,9,988,40,222,2,3,0,267
4988,011K,2040,106,160,5,5,0,276
4989,011K,2041,80,182,2,8,0,272
4990,011K,2042,108,153,2,1,0,264
4991,011K,2043,105,170,0,4,0,279
4992,011K,2044,90,167,1,4,0,262
4993,011K,2045,85,185,3,7,0,280
4994,011K,2046,81,187,1,10,0,279
4995,011K,2047,88,165,0,0,0,253
4996,011K,2048,106,153,0,7,0,266
4997,011K,2049,85,165,2,2,0,254
4998,011K,2050,97,169,2,3,0,271
4999,011K,2051,82,187,0,1,0,270
5000,011K,2052,98,169,3,7,0,277
5001,011K,2053,91,178,0,6,0,275
5002,011K,2054,93,170,0,2,0,265
5003,011K,2055,94,174,0,15,0,283
5004,011K,2056,87,170,2,3,0,262
5005,011K,2057,85,161,5,3,0,254
5006,011K,2058,80,182,2,5,0,269
5007,011K,2059,88,181,2,5,0,276
5008,011K,2060,65,192,2,12,0,271
5009,011K,2061,97,175,1,6,0,279
5010,011K,2062,98,169,2,3,0,272
5011,011K,2063,88,166,5,7,0,266
5012,011K,2064,85,169,3,8,0,265
5013,011K,2065,84,185,1,4,0,274
5014,011K,2066,96,177,2,5,0,280
5015,011K,2067,98,158,0,6,0,262
5016,011K,2068,98,175,1,5,0,279
5017,011K,2069,87,162,1,22,0,272
5018,011K,2070,96,164,1,5,0,266
5019,011K,2071,86,174,1,6,0,267
5020,006B,565,47,121,0,0,0,168
5021,013M,2804,21,162,1,2,0,186
5022,013M,2805,18,147,0,1,0,166
5023,004C,278,61,201,2,2,0,266
5024,004C,279,82,188,2,5,0,277
5025,004C,280,66,203,2,5,0,276
5026,004C,281,78,188,4,3,0,273
5027,004C,282,62,212,1,6,0,281
5028,004C,283,59,214,3,6,0,282
5029,004C,284,64,204,5,7,0,280
5030,004C,285,61,211,2,4,0,278
5031,004C,286,80,196,4,2,0,282
5032,004C,287,70,202,0,9,0,281
5033,004C,288,58,216,6,3,0,283
5034,004C,289,71,198,4,6,0,279
5035,004C,290,74,197,1,7,0,279
5036,014H,3025,59,195,1,7,0,262
5037,014H,3026,45,206,2,2,0,255
5038,014H,3027,63,185,2,9,0,259
5039,014H,3028,61,200,1,8,0,270
5040,014H,3029,65,198,2,6,2,273
5041,014H,3030,63,208,0,5,3,279
5042,014H,3031,51,221,2,4,0,278
5043,014H,3032,68,187,2,10,0,267
5044,014H,3033,55,204,2,4,0,265
5045,014H,3034,62,187,3,7,0,259
5046,014H,3035,65,189,1,5,0,260
5047,014F,2978,59,194,6,5,0,264
5048,014F,2979,73,203,5,3,0,284
5049,014F,2980,50,207,16,3,0,276
5050,014F,2981,55,213,1,1,0,270
5051,014F,2982,58,198,5,2,0,263
5052,014F,2983,47,218,2,6,0,273
5053,014F,2984,63,205,2,5,0,275
5054,014F,2985,53,208,3,3,0,267
5055,014F,2986,55,207,7,5,0,274
5056,014F,2987,47,208,7,7,0,269
5057,014F,2988,45,210,4,3,0,262
5058,014F,2989,73,193,4,4,0,274
5059,014F,2990,47,231,3,3,0,284
5060,014F,2991,64,193,5,5,0,267
5061,014F,2992,57,214,1,1,0,273
5062,014F,2993,55,211,1,3,0,270
5063,014F,2994,47,201,2,5,0,255
5064,014F,2995,53,206,0,5,0,264
5065,014F,2996,58,202,4,6,0,270
5066,014F,2997,51,216,5,3,0,275
5067,012B,2134,64,205,4,0,0,273
5068,012B,2135,54,213,4,2,0,273
5069,012B,2136,65,194,2,8,0,269
5070,012B,2137,64,183,2,2,0,251
5071,012B,2138,61,196,5,5,0,267
5072,012B,2139,55,210,3,5,0,273
5073,012B,2140,53,209,3,3,0,268
5074,012B,2141,54,208,6,3,0,271
5075,012B,2142,56,209,5,1,0,271
5076,012B,2143,58,210,2,4,0,274
5077,012B,2144,62,198,4,7,0,271
5078,012B,2145,49,215,3,1,0,268
5079,012B,2146,52,210,1,0,0,263
5080,012B,2147,51,201,6,4,0,262
5081,012B,2148,40,220,0,2,0,262
5082,012B,2149,65,199,3,5,0,272
5083,012B,2150,47,217,2,1,0,267
5084,012B,2151,46,212,4,4,0,266
5085,012B,2152,48,204,5,6,0,263
5086,012B,2153,56,197,4,4,0,261
5087,012B,2154,59,205,5,2,0,271
5088,012B,2155,46,234,4,0,0,284
5089,012B,2156,57,206,3,4,0,270
5090,012B,2157,53,199,4,4,0,260
5091,012B,2158,53,205,6,4,0,268
5092,012B,2159,41,218,2,4,0,265
5093,012B,2160,57,196,2,4,0,259
5094,012B,2161,73,179,5,7,0,264
5095,012B,2162,60,206,4,2,0,272
5096,012B,2163,50,210,1,10,0,271
5097,012B,2164,63,195,3,2,0,263
5098,012B,2165,70,184,3,1,0,258
5099,012B,2166,67,181,3,2,0,253
5100,012B,2167,53,219,2,2,0,276
5101,012B,2168,52,197,4,2,0,255
5102,012B,2169,66,205,1,0,0,272
5103,012B,2170,59,208,4,2,0,273
5104,012B,2171,51,205,3,4,0,263
5105,012B,2172,52,220,6,3,0,281
5106,012B,2173,48,217,2,5,0,272
5107,012B,2174,65,190,2,6,0,263
5108,012B,2175,68,195,3,2,0,268
5109,012B,2176,51,206,0,0,0,257
5110,012B,2177,70,196,3,8,0,277
5111,012B,2178,53,204,2,6,0,265
5112,012B,2179,67,194,3,1,0,265
5113,012B,2180,54,215,2,0,0,271
5114,012B,2181,56,199,6,4,0,265
5115,012B,2182,65,194,5,2,0,266
5116,012B,2183,54,217,1,0,0,272
5117,012B,2184,59,205,5,5,0,274
5118,012B,2185,53,202,7,3,0,265
5119,012B,2186,64,218,0,4,0,286
5120,012B,2187,44,199,5,6,0,254
5121,012B,2188,61,183,7,0,0,251
5122,012B,2189,52,212,5,1,0,270
5123,012B,2190,66,196,2,3,0,267
5124,012B,2191,40,213,6,3,0,262
5125,012B,2192,37,222,4,6,0,269
5126,012B,2193,45,203,7,5,0,260
5127,012B,2194,59,185,3,0,0,247
5128,012B,2195,72,186,4,5,0,267
5129,012B,2196,59,219,2,4,0,284
5130,012B,2197,68,195,2,1,0,266
5131,012B,2198,65,191,1,2,0,259
5132,012B,2199,61,205,6,2,0,274
5133,012B,2200,53,215,2,3,0,273
5134,014N,3131,67,206,5,6,0,284
5135,014N,3132,74,205,0,7,0,286
5136,014N,3133,61,198,3,1,0,263
5137,014N,3134,75,175,5,5,0,260
5138,014N,3135,74,199,3,6,0,282
5139,014N,3136,69,203,5,3,0,280
5140,014N,3137,71,189,2,9,0,271
5141,014N,3138,78,185,3,11,0,277
5142,014N,3139,68,188,3,13,0,272
5143,014N,3140,68,201,2,0,6,277
5144,014N,3141,75,183,0,3,0,261
5145,014N,3142,65,188,0,11,0,264
5146,014N,3143,81,181,4,11,0,277
5147,014N,3144,85,181,1,4,0,271
5148,014N,3145,66,190,4,8,0,268
5149,014N,3146,69,195,0,13,0,277
5150,014Q,3180,41,202,2,0,0,245
5151,014Q,3181,58,190,0,3,0,251
5152,014Q,3182,52,190,0,0,0,242
5153,014Q,3183,66,174,1,2,0,243
5154,006E,622,98,119,3,8,0,228
5155,006E,623,80,150,1,8,0,239
5156,006E,624,86,137,1,6,0,230
5157,006E,625,110,105,1,4,0,220
5158,006E,626,99,117,1,1,0,218
5159,006E,627,98,128,0,14,0,240
5160,006E,628,90,129,1,7,0,227
5161,010L,1556,98,160,5,3,0,266
5162,010L,1557,80,174,4,6,1,265
5163,010L,1558,75,176,4,4,1,260
5164,010L,1559,83,170,0,14,0,267
5165,010L,1560,97,162,2,3,0,264
5166,010L,1561,81,182,1,10,0,274
5167,010L,1562,76,174,3,6,0,259
5168,010L,1563,71,171,2,7,0,251
5169,010L,1564,95,170,2,3,0,270
5170,010L,1565,76,170,1,7,0,254
5171,010L,1566,84,178,2,5,0,269
5172,010L,1567,85,169,2,7,0,263
5173,010L,1568,84,169,2,3,0,258
5174,010L,1569,92,167,4,2,3,268
5175,010L,1570,110,162,1,4,0,277
5176,010L,1571,78,175,1,7,0,261
5177,010L,1572,71,189,3,4,0,267
5178,010L,1573,93,160,3,5,0,261
5179,010L,1574,62,187,1,9,0,259
5180,010L,1575,72,193,2,6,0,273
5181,010L,1576,87,175,2,8,0,272
5182,010L,1577,85,158,6,8,0,257
5183,010L,1578,87,166,2,6,0,261
5184,010L,1579,75,191,2,8,0,276
5185,010L,1580,83,178,4,8,0,273
5186,010L,1581,80,187,0,3,0,270
5187,010L,1582,67,198,0,4,1,270
5188,010L,1583,74,189,3,10,0,276
5189,010L,1584,95,169,3,3,0,270
5190,010L,1585,93,169,1,6,0,269
5191,010L,1586,87,157,1,4,0,249
5192,010L,1587,70,173,3,7,0,253
5193,010L,1588,68,196,3,4,0,271
5194,010L,1589,80,178,5,10,0,273
5195,010L,1590,97,156,0,3,0,256
5196,010L,1591,74,182,3,3,0,262
5197,010L,1592,73,177,2,9,0,261
5198,010L,1593,75,188,0,1,0,264
5199,010L,1594,75,170,1,9,0,255
5200,010L,1595,72,183,2,8,0,265
5201,010L,1596,77,169,5,4,0,255
5202,010L,1597,74,188,3,8,0,273
5203,010L,1598,88,193,0,1,0,282
5204,010L,1599,69,195,1,8,0,273
5205,010L,1600,88,164,3,8,0,263
5206,010L,1601,91,173,3,6,0,273
5207,010L,1602,86,157,3,5,0,251
5208,010L,1603,85,175,2,4,0,266
5209,010L,1604,72,169,3,7,0,251
5210,010L,1605,65,188,3,3,0,259
5211,010L,1606,92,156,2,5,0,255
5212,010L,1607,69,158,7,6,1,241
5213,010L,1608,80,179,1,8,0,268
5214,010L,1609,90,150,4,4,0,248
5215,010L,1610,104,143,1,4,0,252
5216,010L,1611,70,193,2,8,0,273
5217,010L,1612,70,184,2,5,0,261
5218,010L,1613,100,175,1,5,0,281
5219,010L,1614,77,176,11,2,0,266
5220,010L,1615,84,158,3,8,0,253
5221,010L,1616,88,150,2,5,0,245
5222,010L,1617,65,201,2,3,0,271
5223,010L,1618,78,183,1,4,0,266
5224,010L,1619,73,170,2,2,0,247
5225,010L,1620,73,178,4,12,0,267
5226,010L,1621,87,175,3,7,0,272
5227,010L,1622,94,165,1,10,0,270
5228,010L,1623,85,172,3,5,0,265
5229,010L,1624,100,147,5,4,13,269
5230,010L,1625,61,213,4,8,0,286
5231,010L,1626,73,176,2,2,0,253
5232,010L,1627,84,175,4,1,0,264
5233,010L,1628,71,187,3,7,0,268
5234,010L,1629,80,171,3,5,0,259
5235,010L,1630,61,183,4,6,3,257
5236,010L,1631,73,190,3,6,0,272
5237,013E,2555,50,192,0,3,0,245
5238,013E,2556,62,160,3,4,0,229
5239,013E,2557,56,180,0,10,1,247
5240,013E,2558,66,167,4,3,0,240
5241,007D,740,58,190,5,3,0,256
5242,007D,741,64,182,5,8,0,259
5243,007D,742,55,191,4,6,0,256
5244,007D,743,67,196,4,2,0,269
5245,007D,744,64,183,3,3,0,253
5246,007D,745,56,199,3,4,0,262
5247,007D,746,66,194,5,6,0,271
5248,007D,747,66,172,5,3,0,246
5249,007D,748,68,186,3,2,0,259
5250,007D,749,65,198,2,6,0,271
5251,007D,750,62,200,2,1,0,265
5252,007D,751,57,199,3,0,0,259
5253,007D,752,49,196,5,2,0,252
5254,007D,753,54,219,3,4,0,280
5255,007D,754,68,195,3,3,0,269
5256,007D,755,62,202,2,4,0,270
5257,007D,756,47,224,2,3,0,276
5258,007D,757,61,192,2,4,0,259
5259,007D,758,58,199,4,1,1,263
5260,007D,759,46,211,4,1,0,262
5261,007D,760,40,215,4,4,0,263
5262,007D,761,63,187,1,1,0,252
5263,007D,762,57,196,4,2,0,259
5264,007D,763,58,208,0,6,0,272
5265,007D,764,67,190,2,5,0,264
5266,007D,765,36,211,3,2,0,252
5267,007D,766,53,183,3,3,0,242
5268,011L,2072,21,254,2,1,0,278
5269,011L,2073,18,269,2,0,0,289
5270,011L,2074,21,260,0,1,0,282
5271,011L,2075,7,271,2,1,0,281
5272,011L,2076,18,259,1,1,0,279
5273,011L,2077,15,258,3,2,0,278
5274,011L,2078,20,265,3,1,0,289
5275,011L,2079,17,269,1,0,0,287
5276,11,1637,67,166,1,7,0,241
5277,11,1638,78,172,2,5,0,257
5278,11,1639,78,150,3,4,0,235
5279,11,1640,71,169,4,3,0,247
5280,11,1641,69,165,1,10,0,245
5281,11,1642,85,168,1,4,0,258
5282,11,1643,67,190,0,3,0,260
5283,11,1644,64,175,1,5,0,245
5284,11,1645,91,154,1,3,0,249
5285,11,1646,71,173,2,6,0,252
5286,11,1647,75,175,5,2,0,257
5287,11,1648,69,174,1,4,0,248
5288,11,1649,94,164,3,4,0,265
5289,11,1650,70,168,2,1,0,241
5290,005B,367,55,214,0,1,0,270
5291,005B,368,63,202,3,2,0,270
5292,005B,369,64,196,2,9,0,271
5293,005B,370,57,215,6,3,0,281
5294,005B,371,54,210,4,7,0,275
5295,005B,372,45,222,0,1,0,268
5296,006F,629,76,190,7,3,0,276
5297,006F,630,82,180,8,5,0,275
5298,006F,631,65,192,3,6,0,266
5299,006F,632,75,189,2,6,0,272
5300,006F,633,85,193,3,2,0,283
5301,006F,634,85,171,4,10,0,270
5302,006F,635,86,155,3,5,0,249
5303,006F,636,90,188,2,3,0,283
5304,006F,637,79,175,2,7,0,263
5305,006F,638,69,174,3,5,1,252
5306,006F,639,79,167,6,9,0,261
5307,006F,640,66,181,2,8,0,257
5308,006F,641,87,163,5,6,1,262
5309,006F,642,74,201,0,2,0,277
5310,006F,643,65,185,6,0,0,256
5311,006F,644,110,146,0,9,3,268
5312,006F,645,70,166,1,8,1,246
5313,006F,646,72,179,2,3,0,256
5314,006F,647,63,184,5,9,0,261
5315,006F,648,82,184,1,5,0,272
5316,006F,649,71,191,3,5,2,272
5317,006F,650,83,163,4,12,6,268
5318,006F,651,79,184,1,13,1,278
5319,006C,566,56,212,5,4,0,277
5320,006C,567,51,219,6,1,0,277
5321,006C,568,62,194,2,5,0,263
5322,006C,569,42,207,2,3,0,254
5323,006C,570,58,218,2,0,0,278
5324,006C,571,38,214,0,6,0,258
5325,006C,572,57,199,4,5,0,265
5326,006C,573,54,216,5,1,0,276
5327,006C,574,61,194,6,7,0,268
5328,006C,575,52,207,1,4,0,264
5329,006C,576,54,201,1,4,0,260
5330,006C,577,58,208,1,5,0,272
5331,006C,578,53,205,3,3,0,264
5332,006C,579,56,186,5,7,0,254
5333,006C,580,61,202,3,2,0,268
5334,006C,581,52,210,3,4,0,269
5335,006C,582,59,202,3,3,1,268
5336,006C,583,50,209,3,2,0,264
5337,006C,584,48,217,2,4,0,271
5338,006C,585,51,212,5,5,0,273
5339,006C,586,42,229,1,3,0,275
5340,006C,587,60,193,6,1,0,260
5341,006C,588,60,203,4,6,0,273
5342,006C,589,56,200,1,3,1,261
5343,006C,590,60,206,1,2,0,269
5344,006C,591,39,226,4,3,0,272
5345,006C,592,48,194,16,3,0,261
5346,006C,593,63,200,5,3,0,271
5347,006C,594,66,204,4,3,0,277
5348,006C,595,61,211,5,0,0,277
5349,006C,596,55,200,4,3,0,262
5350,006C,597,60,203,5,2,0,270
5351,006C,598,59,203,0,3,0,265
5352,006C,599,53,219,9,3,0,284
5353,006C,600,64,187,3,3,0,257
5354,012E,2289,74,169,2,1,0,246
5355,012E,2290,68,171,4,7,0,250
5356,012E,2291,75,171,0,8,0,254
5357,012E,2292,68,174,2,0,5,249
5358,012E,2293,67,187,9,2,1,266
5359,012E,2294,84,170,2,8,0,264
5360,012E,2295,73,189,2,8,0,272
5361,012E,2296,0,0,0,0,0,0
5362,012E,2297,68,200,1,5,0,274
5363,012E,2298,85,159,0,15,0,259
5364,012E,2299,98,178,0,7,0,283
5365,012E,2300,73,191,8,2,0,274
5366,012E,2301,74,185,3,5,0,267
5367,012E,2302,85,180,5,5,0,275
5368,010M,1632,114,129,2,13,0,258
5369,010M,1633,115,146,3,7,0,271
5370,010M,1634,91,154,5,6,0,256
5371,010M,1635,119,127,1,8,0,255
5372,010M,1636,89,148,5,8,4,254
5373,10,1174,78,182,2,7,0,269
5374,10,1175,59,184,3,9,0,255
5375,10,1176,72,179,3,4,0,258
5376,10,1177,85,172,1,5,0,263
5377,10,1178,78,179,5,1,0,263
5378,10,1179,61,190,4,5,0,260
5379,10,1180,75,178,11,0,0,264
5380,10,1181,79,157,3,4,1,244
5381,10,1182,66,182,3,6,0,257
5382,10,1183,74,181,9,0,0,264
5383,10,1184,88,165,6,8,0,267
5384,10,1185,71,163,3,6,0,243
5385,10,1186,76,167,0,7,0,250
5386,10,1187,63,187,3,7,0,260
5387,10,1188,73,196,5,4,0,278
5388,10,1189,72,174,2,4,0,252
5389,10,1190,81,170,3,8,0,262
5390,10,1191,85,176,6,4,0,271
5391,10,1192,69,177,4,4,1,255
5392,10,1193,69,177,1,5,0,252
5393,10,1194,66,172,3,6,0,247
5394,10,1195,74,165,3,8,0,250
5395,10,1196,77,178,0,3,0,258
5396,10,1197,79,175,2,3,0,259
5397,10,1198,56,174,2,4,0,236
5398,10,1199,74,175,2,4,0,255
5399,10,1200,100,154,4,7,0,265
5400,10,1201,74,174,1,7,0,256
5401,10,1202,80,173,2,5,0,260
5402,10,1203,91,172,4,1,0,268
5403,10,1204,70,175,2,3,1,251
5404,10,1205,79,169,2,9,0,259
5405,10,1206,68,174,5,7,0,254
5406,10,1207,58,185,1,8,0,252
5407,10,1208,88,152,5,2,1,248
5408,10,1209,67,173,2,4,0,246
5409,10,1210,67,174,4,6,0,251
5410,10,1211,63,189,3,3,0,258
5411,10,1212,63,200,3,2,0,268
5412,10,1213,77,168,1,4,0,250
5413,10,1214,78,179,2,3,0,262
5414,10,1215,71,159,3,7,1,241
5415,10,1216,61,188,3,2,0,254
5416,10,1217,65,179,2,12,0,258
5417,10,1218,71,191,6,4,0,272
5418,10,1219,62,202,4,4,0,272
5419,10,1220,85,164,7,5,0,261
5420,10,1221,72,186,2,4,0,264
5421,10,1222,98,167,3,5,0,273
5422,10,1223,75,180,0,7,0,262
5423,10,1224,76,165,7,4,3,255
5424,010C,1275,92,178,1,5,0,276
5425,010C,1276,91,161,2,9,0,263
5426,010C,1277,89,171,3,5,0,268
5427,010C,1278,93,178,1,2,0,274
5428,010C,1279,110,150,1,2,0,263
5429,010C,1280,92,169,3,5,0,269
5430,010C,1281,92,182,2,10,0,286
5431,010C,1282,113,160,1,2,0,276
5432,010C,1283,112,136,3,4,0,255
5433,010C,1284,82,176,0,5,0,263
5434,010C,1285,90,168,2,9,0,269
5435,010C,1286,88,169,0,8,0,265
5436,010C,1287,101,167,2,3,0,273
5437,010C,1288,79,189,5,3,0,276
5438,010C,1289,102,179,2,6,0,289
5439,010C,1290,97,166,3,5,0,271
5440,010C,1291,94,168,3,3,0,268
5441,010C,1292,77,176,4,2,0,259
5442,010C,1293,105,148,4,2,0,259
5443,010C,1294,84,176,1,1,0,262
5444,013L,2802,26,136,0,2,0,164
5445,013L,2803,37,123,0,6,0,166
5446,009F,1111,55,192,0,5,0,252
5447,009F,1112,53,202,5,1,0,261
5448,009F,1113,84,183,6,2,0,275
5449,009F,1114,53,215,0,7,0,275
5450,009F,1115,62,203,1,2,0,268
5451,009F,1116,47,216,5,6,0,274
5452,009F,1117,61,207,5,4,0,277
5453,009F,1118,36,214,6,3,0,259
5454,009F,1119,61,204,1,6,0,272
5455,009F,1120,56,197,3,8,0,264
5456,009F,1121,60,194,11,6,0,271
5457,009F,1122,55,213,2,5,0,275
5458,009F,1123,65,192,4,4,0,265
5459,009F,1124,64,206,3,2,0,275
5460,009F,1125,65,199,1,6,0,271
5461,009F,1126,61,202,8,3,0,274
5462,009F,1127,54,188,3,4,0,249
5463,009F,1128,56,201,2,4,0,263
5464,009F,1129,63,204,2,3,0,272
5465,009F,1130,58,212,0,5,0,275
5466,009F,1131,52,188,0,4,0,244
5467,009F,1132,61,196,5,4,0,266
5468,009F,1133,62,190,1,4,0,257
5469,009F,1134,54,202,3,4,0,263
5470,009F,1135,56,200,3,5,0,264
5471,009F,1136,60,204,4,1,0,269
5472,009F,1137,48,195,3,7,0,253
5473,009F,1138,70,183,3,3,0,259
5474,009F,1139,64,188,1,5,0,258
5475,009F,1140,46,212,1,2,0,261
5476,009F,1141,70,199,1,3,0,273
5477,009F,1142,61,185,1,14,0,261
5478,009F,1143,55,208,1,5,0,269
5479,009F,1144,58,189,6,5,0,258
5480,009F,1145,60,196,1,2,0,259
5481,009F,1146,60,193,0,3,0,256
5482,009F,1147,47,215,0,3,0,265
5483,009F,1148,68,201,0,5,0,274
5484,009F,1149,55,208,4,6,0,273
5485,009F,1150,54,194,1,7,0,256
5486,009F,1151,55,192,4,6,0,257
5487,009F,1152,69,188,0,11,0,268
5488,009F,1153,51,212,2,5,0,270
5489,009F,1154,56,200,3,2,0,261
5490,009F,1155,48,205,4,4,0,261
5491,011J,1989,50,196,5,3,0,254
5492,011J,1990,45,217,3,3,0,268
5493,011J,1991,62,195,5,5,0,267
5494,011J,1992,69,196,6,8,0,279
5495,011J,1993,58,211,2,2,0,273
5496,011J,1994,77,183,6,4,0,270
5497,011J,1995,58,216,3,5,0,282
5498,011J,1996,63,198,3,3,0,267
5499,011J,1997,68,202,6,2,0,278
5500,011J,1998,51,218,1,2,0,272
5501,011J,1999,47,207,7,5,0,266
5502,011J,2000,65,206,3,7,0,281
5503,011J,2001,59,206,3,6,0,274
5504,011J,2002,44,210,6,5,0,265
5505,011J,2003,61,212,2,4,0,279
5506,011J,2004,62,209,2,5,0,278
5507,011J,2005,76,181,1,4,0,262
5508,011J,2006,51,225,0,3,0,279
5509,011J,2007,47,221,3,8,0,279
5510,011J,2008,45,209,5,5,0,264
5511,011J,2009,59,207,2,2,0,270
5512,011J,2010,67,183,4,6,0,260
5513,011J,2011,69,190,5,3,0,267
5514,011J,2012,65,206,1,4,0,276
5515,011J,2013,61,199,3,10,0,273
5516,011J,2014,64,203,4,4,0,275
5517,011J,2015,52,215,3,3,4,277
5518,011J,2016,44,219,4,3,0,270
5519,011J,2017,45,209,5,1,0,260
5520,011J,2018,62,202,3,6,0,273
5521,011J,2019,51,214,2,4,0,271
5522,011J,2020,50,199,6,9,0,264
5523,011J,2021,63,216,3,3,0,285
5524,011J,2022,59,216,5,7,0,287
5525,011J,2023,53,207,7,6,0,273
5526,011J,2024,58,199,6,4,0,267
5527,011J,2025,65,193,5,4,0,267
5528,011J,2026,56,217,5,1,0,279
5529,011J,2027,74,194,2,7,0,277
5530,011J,2028,68,195,2,2,0,267
5531,011J,2029,61,203,1,2,0,267
5532,011J,2030,62,193,4,4,0,263
5533,011J,2031,68,204,3,3,0,278
5534,011J,2032,42,218,3,6,0,269
5535,011J,2033,44,214,8,3,0,269
5536,011J,2034,44,214,4,5,0,267
5537,011J,2035,74,194,3,5,0,276
5538,011J,2036,51,221,0,6,0,278
5539,011J,2037,52,211,3,0,0,266
5540,011J,2038,57,207,3,5,0,272
5541,011J,2039,54,214,4,3,0,275
5542,005E,457,90,187,0,6,0,283
5543,005E,458,70,202,2,4,0,278
5544,005E,459,87,181,0,4,0,272
5545,005E,460,86,165,4,10,0,265
5546,005E,461,82,195,1,5,0,283
5547,005E,462,81,172,3,10,0,266
5548,005E,463,78,191,3,2,0,274
5549,005E,464,85,173,2,5,0,265
5550,005E,465,68,183,1,8,0,260
5551,005E,466,80,180,3,1,0,264
5552,005E,467,61,188,2,2,0,253
5553,005E,468,77,181,1,5,0,264
5554,013A,2456,46,219,4,7,0,276
5555,013A,2457,66,211,2,4,0,283
5556,013A,2458,53,208,2,11,0,274
5557,013A,2459,45,225,3,4,1,278
5558,013A,2460,62,213,2,3,5,285
5559,013A,2461,41,236,1,5,0,283
5560,013A,2462,0,0,0,0,0,0
5561,013A,2463,56,212,2,4,0,274
5562,013A,2464,60,213,1,2,0,276
5563,013A,2465,38,233,2,3,0,276
5564,013A,2466,56,227,3,1,0,287
5565,013A,2467,69,196,5,5,0,275
5566,013A,2468,57,211,5,7,0,280
5567,013A,2469,73,204,1,6,0,284
5568,013A,2470,54,213,8,0,0,275
5569,013A,2471,63,204,6,6,0,279
5570,013A,2472,57,217,3,6,0,283
5571,013A,2473,62,202,2,11,0,277
5572,013A,2474,35,231,3,5,0,274
5573,013A,2475,45,218,2,14,0,279
5574,013A,2476,54,211,5,8,0,278
5575,013A,2477,65,195,5,7,0,272
5576,013A,2478,60,211,1,5,0,277
5577,013A,2479,67,205,5,2,0,279
5578,013A,2480,50,224,1,5,0,280
5579,013A,2481,65,214,3,6,0,288
5580,013A,2482,46,241,3,3,0,293
5581,013A,2483,53,226,0,6,0,285
5582,013A,2484,53,225,1,4,0,283
5583,013A,2485,66,192,2,5,0,265
5584,013A,2486,41,228,1,3,0,273
5585,013A,2487,53,213,2,1,0,269
5586,013A,2488,57,224,0,6,0,287
5587,013A,2489,51,205,1,3,0,260
5588,013A,2490,56,222,1,5,0,284
5589,013A,2491,46,230,1,5,0,282
5590,013A,2492,57,230,3,6,0,296
5591,013A,2493,49,225,3,5,0,282
5592,013A,2494,69,197,4,8,0,278
5593,013A,2495,87,190,1,4,0,282
5594,013A,2496,63,205,3,5,0,276
5595,013A,2497,65,212,1,4,0,282
5596,013A,2498,57,226,4,3,0,290
5597,013A,2499,56,221,3,5,0,285
5598,013A,2500,47,204,2,10,0,263
5599,013A,2501,63,230,2,2,0,297
5600,013A,2502,55,225,2,2,0,284
5601,013A,2503,53,210,5,4,0,272
5602,013A,2504,44,231,2,6,0,283
5603,008C,946,45,220,2,3,0,270
5604,008C,947,52,195,4,9,2,262
5605,008C,948,44,228,4,2,0,278
5606,008C,949,43,214,2,1,0,260
5607,008C,950,64,183,2,7,15,271
5608,008C,951,49,215,3,5,0,272
5609,008C,952,69,200,2,8,0,279
5610,008C,953,71,188,3,6,0,268
5611,008C,954,66,206,3,2,0,277
5612,008C,955,42,224,2,4,0,272
5613,008C,956,61,200,5,9,0,275
5614,008C,957,46,215,2,3,0,266
5615,008C,958,53,213,2,5,0,273
5616,008C,959,65,200,1,6,0,272
5617,008C,960,62,198,4,5,0,269
5618,008C,961,61,203,1,8,0,273
5619,008C,962,57,213,1,1,0,272
5620,008C,963,77,191,0,4,0,272
5621,008C,964,64,199,5,7,0,275
5622,008C,965,73,182,6,13,0,274
5623,008C,966,52,207,3,2,0,264
5624,008C,967,73,195,3,4,0,275
5625,008C,968,51,217,0,6,0,274
5626,008C,969,48,197,4,4,0,253
5627,008C,970,41,214,6,9,0,270
5628,006A,564,58,142,2,4,0,206
5629,011A,1651,61,187,1,4,0,253
5630,011A,1652,68,178,1,3,0,250
5631,011A,1653,57,204,5,4,0,270
5632,011A,1654,53,202,3,3,0,261
5633,011A,1655,58,187,2,3,0,250
5634,011A,1656,70,175,2,5,0,252
5635,011A,1657,69,189,3,4,0,265
5636,011A,1658,55,176,4,7,0,242
5637,011A,1659,53,189,1,1,0,244
5638,011A,1660,61,190,5,4,0,260
5639,011A,1661,69,193,1,2,0,265
5640,011A,1662,56,195,2,0,0,253
5641,011A,1663,54,192,4,10,0,260
5642,011A,1664,58,204,1,0,0,263
5643,011A,1665,88,165,6,0,0,259
5644,011A,1666,50,205,3,4,0,262
5645,011A,1667,68,175,4,7,0,254
5646,011A,1668,69,182,2,2,2,257
5647,011A,1669,65,200,4,4,1,274
5648,011A,1670,78,171,3,5,3,260
5649,011A,1671,68,179,6,5,1,259
5650,011A,1672,66,180,3,7,0,256
5651,011A,1673,68,195,3,2,7,275
5652,011A,1674,54,187,2,1,0,244
5653,011A,1675,56,200,3,1,0,260
5654,011A,1676,84,167,1,4,0,256
5655,011A,1677,48,207,5,5,0,265
5656,011A,1678,54,216,1,3,0,274
5657,011A,1679,62,194,7,9,0,272
5658,011A,1680,58,175,2,20,2,257
5659,011A,1681,53,186,2,4,0,245
5660,011A,1682,62,190,4,3,0,259
5661,011A,1683,59,186,4,1,0,250
5662,011A,1684,73,173,1,2,0,249
5663,011A,1685,64,176,2,3,1,246
5664,011A,1686,52,211,0,3,0,266
5665,011A,1687,62,191,0,4,0,257
5666,011A,1688,69,192,2,4,1,268
5667,011A,1689,65,189,5,3,0,262
5668,011A,1690,67,191,1,3,0,262
5669,011A,1691,61,187,3,4,1,256
5670,011A,1692,72,188,3,3,0,266
5671,011A,1693,72,176,0,1,1,250
5672,011A,1694,61,193,3,1,0,258
5673,011A,1695,66,181,3,5,0,255
5674,011A,1696,69,182,5,2,0,258
5675,011A,1697,67,191,1,3,0,262
5676,011A,1698,70,182,0,1,0,253
5677,011A,1699,51,202,5,3,0,261
5678,011A,1700,50,189,1,3,0,243
5679,011A,1701,66,190,1,5,0,262
5680,011A,1702,67,204,2,6,0,279
5681,011A,1703,69,187,0,3,0,259
5682,011A,1704,66,180,3,1,0,250
5683,011A,1705,67,176,1,2,2,248
5684,011A,1706,63,178,5,0,0,246
5685,011A,1707,63,189,1,5,0,258
5686,011A,1708,69,186,6,2,1,264
5687,011A,1709,73,179,1,4,0,257
5688,011A,1710,61,182,3,5,0,251
5689,011A,1711,63,160,5,5,0,233
5690,011A,1712,74,183,1,2,0,260
5691,011A,1713,58,196,2,4,0,260
5692,011A,1714,65,184,2,4,0,255
5693,011A,1715,59,193,4,3,0,259
5694,011A,1716,75,166,3,4,0,248
5695,011A,1717,76,195,1,7,0,279
5696,011A,1718,65,175,2,5,0,247
5697,011M,2080,29,261,2,1,0,293
5698,011M,2081,22,281,4,1,0,308
5699,011M,2082,30,265,5,1,0,301
5700,011M,2083,37,254,4,1,0,296
5701,011M,2084,36,274,0,0,0,310
5702,011M,2085,33,259,3,1,0,296
5703,011M,2086,35,266,1,0,0,302
5704,011M,2087,37,253,4,0,0,294
5705,011M,2088,26,275,6,1,0,308
5706,011M,2089,27,275,4,1,0,307
5707,011M,2090,27,274,1,0,0,302
5708,011M,2091,30,265,1,2,0,298
5709,3,64,77,188,8,4,0,277
5710,3,65,63,200,7,2,0,272
5711,3,66,60,199,3,4,0,266
5712,3,67,66,203,4,4,0,277
5713,3,68,85,171,4,0,0,260
5714,3,69,65,193,3,3,0,264
5715,3,70,63,209,3,3,0,278
5716,3,71,44,215,8,3,0,270
5717,3,72,64,205,6,3,0,278
5718,3,73,66,192,3,3,0,264
5719,3,74,65,179,4,5,0,253
5720,3,75,65,202,3,1,0,271
5721,3,76,55,200,3,2,0,260
5722,3,77,61,191,8,2,0,262
5723,3,78,60,204,5,5,0,274
5724,3,79,67,192,6,7,0,272
5725,3,80,53,216,8,3,0,280
5726,3,81,51,223,4,4,0,282
5727,3,82,68,200,2,2,0,272
5728,3,83,64,204,5,4,0,277
5729,3,84,65,195,3,3,0,266
5730,3,85,60,191,1,8,0,260
5731,3,86,66,200,1,2,0,269
5732,3,87,77,182,6,2,0,267
5733,3,88,72,184,8,4,0,268
5734,3,89,74,190,5,2,3,274
5735,3,90,62,182,3,1,0,248
5736,3,91,79,185,2,11,0,277
5737,3,92,62,186,4,5,0,257
5738,3,93,71,182,8,2,0,263
5739,3,94,64,194,5,2,0,265
5740,3,95,64,182,2,4,0,252
5741,3,96,61,189,2,3,0,255
5742,3,97,51,199,7,4,0,261
5743,3,98,68,207,4,1,0,280
5744,3,99,60,200,6,3,0,269
5745,3,100,65,189,5,0,0,259
5746,3,101,57,199,5,3,0,264
5747,3,102,72,201,1,3,0,277
5748,3,103,63,187,8,6,0,264
5749,3,104,71,187,4,4,0,266
5750,3,105,76,185,2,3,0,266
5751,3,106,65,206,4,2,0,277
5752,3,107,64,188,6,1,0,259
5753,3,108,79,176,5,4,0,264
5754,3,109,70,187,5,5,0,267
5755,3,110,80,186,5,6,0,277
5756,3,111,71,169,3,7,0,250
5757,3,112,73,203,4,4,0,284
5758,3,113,65,207,5,3,0,280
5759,3,114,65,199,3,5,0,272
5760,3,115,62,190,2,1,0,255
5761,3,116,71,195,4,2,0,272
5762,3,117,73,191,4,4,0,272
5763,3,118,65,187,7,1,0,260
5764,3,119,66,190,5,2,0,263
5765,3,120,59,199,4,5,0,267
5766,3,121,63,189,4,6,0,262
5767,007G,838,60,201,2,12,0,275
5768,007G,839,82,186,5,4,0,277
5769,007G,840,63,199,3,2,0,267
5770,007G,841,79,178,1,6,0,264
5771,007G,842,68,201,4,4,0,277
5772,007G,843,75,201,4,3,0,283
5773,007G,844,84,174,0,7,0,265
5774,007G,845,62,185,1,18,0,266
5775,007G,846,90,185,5,2,0,282
5776,007G,847,71,195,1,10,0,277
5777,007G,848,64,194,6,3,0,267
5778,007G,849,72,199,4,3,0,278
5779,007G,850,76,199,4,5,0,284
5780,007G,851,72,201,2,7,0,282
5781,007G,852,69,182,2,7,0,260
5782,007G,853,51,199,2,11,0,263
5783,007G,854,65,193,3,7,0,268
5784,007G,855,67,192,3,3,0,265
5785,007G,856,63,209,3,3,0,278
5786,007G,857,64,206,3,5,0,278
5787,007G,858,66,199,3,3,0,271
5788,007G,859,57,194,3,1,0,255
5789,007G,860,64,197,1,4,0,266
5790,007G,861,62,201,0,7,0,270
5791,007G,862,57,208,0,2,0,267
5792,007G,863,87,190,2,2,0,281
5793,007G,864,74,200,2,4,0,280
5794,007G,865,73,184,1,9,0,267
5795,007G,866,87,177,1,5,0,270
5796,007G,867,90,161,3,6,0,260
5797,007G,868,78,176,3,3,0,260
5798,007G,869,70,189,3,6,0,268
5799,007G,870,75,179,2,6,3,265
5800,007G,871,76,189,3,3,0,271
5801,007G,872,59,222,2,8,0,291
5802,007G,873,70,193,3,3,1,270
5803,013C,2506,55,194,6,4,0,259
5804,013C,2507,57,197,2,5,1,262
5805,013C,2508,53,198,11,2,0,264
5806,013C,2509,67,180,1,3,0,251
5807,013C,2510,53,207,1,9,0,270
5808,013C,2511,59,176,0,9,0,244
5809,013C,2512,57,177,2,8,0,244
5810,013C,2513,49,204,2,4,0,259
5811,013C,2514,66,186,1,6,0,259
5812,013C,2515,57,189,0,5,0,251
5813,013C,2516,62,189,1,10,0,262
5814,013C,2517,72,189,6,3,0,270
5815,013C,2518,56,189,5,11,0,261
5816,013C,2519,60,192,6,6,0,264
5817,013C,2520,67,193,2,4,0,266
5818,013C,2521,55,202,1,3,0,261
5819,013C,2522,55,192,3,8,0,258
5820,013C,2523,54,200,4,6,0,264
5821,013C,2524,65,176,3,4,0,248
5822,013C,2525,52,195,3,7,0,257
5823,013C,2526,55,177,2,4,0,238
5824,013C,2527,42,211,2,3,0,258
5825,013C,2528,49,198,1,3,0,251
5826,013C,2529,48,199,2,11,0,260
5827,013C,2530,69,188,0,6,0,263
5828,013C,2531,67,198,3,14,0,282
5829,013C,2532,41,228,1,7,0,277
5830,013C,2533,52,181,2,2,0,237
5831,013C,2534,51,206,2,4,0,263
5832,013C,2535,50,218,2,4,1,275
5833,013C,2536,60,206,1,1,0,268
5834,013C,2537,57,194,2,3,0,256
5835,013C,2538,59,203,1,1,0,264
5836,013C,2539,57,192,1,4,0,254
5837,013C,2540,65,201,2,4,0,272
5838,013C,2541,62,192,2,7,0,263
5839,013C,2542,58,197,0,0,5,260
5840,013C,2543,48,190,1,11,0,250
5841,013C,2544,64,185,1,2,0,252
5842,013C,2545,55,184,5,5,0,249
5843,013C,2546,38,199,2,7,0,246
5844,013O,2828,141,94,1,4,0,240
5845,013O,2829,137,103,1,6,0,247
5846,013O,2830,150,86,5,0,0,241
5847,013O,2831,123,102,11,0,0,236
5848,013H,2635,69,188,1,5,0,263
5849,013H,2636,69,193,1,4,0,267
5850,013H,2637,74,190,0,9,0,273
5851,013H,2638,69,197,2,5,0,273
5852,013H,2639,53,204,0,4,0,261
5853,013H,2640,70,192,3,6,0,271
5854,013H,2641,48,224,1,3,0,276
5855,013H,2642,60,213,2,8,0,283
5856,013H,2643,51,212,0,5,0,268
5857,013H,2644,69,180,2,2,0,253
5858,013H,2645,73,192,2,7,1,275
5859,013H,2646,57,202,2,4,0,265
5860,013H,2647,58,201,5,8,1,273
5861,013H,2648,73,175,1,4,0,253
5862,013H,2649,56,192,2,3,0,253
5863,013H,2650,65,189,1,9,0,264
5864,013H,2651,50,200,1,4,0,255
5865,013H,2652,74,180,2,6,0,262
5866,013H,2653,46,220,3,7,0,276
5867,013H,2654,54,197,7,3,0,261
5868,013H,2655,59,199,2,4,0,264
5869,013H,2656,49,180,2,11,0,242
5870,013H,2657,54,200,1,7,0,262
5871,013H,2658,50,206,3,9,0,268
5872,013H,2659,76,177,8,3,0,264
5873,013H,2660,61,201,1,3,0,266
5874,013H,2661,60,191,4,7,0,262
5875,013H,2662,71,200,1,9,0,281
5876,013H,2663,47,220,0,7,0,274
5877,013H,2664,67,203,1,5,0,276
5878,013H,2665,76,186,3,7,0,272
5879,013H,2666,90,172,2,3,0,267
5880,013H,2667,73,178,4,6,0,261
5881,013H,2668,70,142,4,6,0,222
5882,013H,2669,65,202,2,3,0,272
5883,013H,2670,57,186,13,0,0,256
5884,013H,2671,68,192,4,0,0,264
5885,013H,2672,49,212,2,3,0,266
5886,013H,2673,64,191,1,7,0,263
5887,013H,2674,61,202,1,3,0,267
5888,013H,2675,75,184,4,6,0,269
5889,013H,2676,91,175,5,0,0,271
5890,013H,2677,50,210,0,8,0,268
5891,013H,2678,60,180,4,10,0,254
5892,013H,2679,69,182,2,3,0,256
5893,013H,2680,68,186,2,3,3,262
5894,013H,2681,59,196,6,7,0,268
5895,013H,2682,82,155,3,3,0,243
5896,013H,2683,73,180,0,7,0,260
5897,013H,2684,52,212,2,3,0,269
5898,013H,2685,49,208,2,4,0,263
5899,014M,3102,56,202,4,1,0,263
5900,014M,3103,57,207,2,4,0,270
5901,014M,3104,37,230,2,5,0,274
5902,014M,3105,36,228,2,3,0,269
5903,014M,3106,43,235,4,4,0,286
5904,014M,3107,36,237,2,0,1,276
5905,014M,3108,40,234,7,2,0,283
5906,014M,3109,56,211,4,3,0,274
5907,014M,3110,56,216,2,4,0,278
5908,014M,3111,45,214,1,1,0,261
5909,014M,3112,51,214,3,1,0,269
5910,014M,3113,49,213,3,1,0,266
5911,014M,3114,41,215,6,0,0,262
5912,014M,3115,52,213,4,2,0,271
5913,014M,3116,56,222,4,3,1,286
5914,014M,3117,46,229,3,3,0,281
5915,014M,3118,41,228,2,0,0,271
5916,014M,3119,58,193,6,5,0,262
5917,014M,3120,49,222,1,6,0,278
5918,014M,3121,36,238,4,4,0,282
5919,014M,3122,35,255,2,2,0,294
5920,014M,3123,42,225,2,1,0,270
5921,014M,3124,38,224,11,5,0,278
5922,014M,3125,41,206,3,5,0,255
5923,014M,3126,48,208,7,1,0,264
5924,014M,3127,45,233,4,0,0,282
5925,014M,3128,40,226,2,2,0,270
5926,014M,3129,46,218,1,2,0,267
5927,014M,3130,28,223,1,4,0,256
5928,011C,1739,60,226,1,3,0,290
5929,011C,1740,45,230,1,6,0,282
5930,011C,1741,67,219,4,1,0,291
5931,011C,1742,60,222,4,5,0,291
5932,011C,1743,60,213,1,4,0,278
5933,011C,1744,51,223,2,2,0,278
5934,011C,1745,57,214,1,2,0,274
5935,011C,1746,74,204,3,0,0,281
5936,011C,1747,63,222,3,8,0,296
5937,011C,1748,55,222,1,6,0,284
5938,011C,1749,52,229,6,3,0,290
5939,011C,1750,62,223,1,4,0,290
5940,011C,1751,51,224,1,0,0,276
5941,011C,1752,60,229,4,2,0,295
5942,011C,1753,69,211,2,5,1,288
5943,011C,1754,66,213,1,5,0,285
5944,011C,1755,48,234,5,3,0,290
5945,011C,1756,68,222,8,4,0,302
5946,011C,1757,50,216,1,2,0,269
5947,011C,1758,71,215,3,0,0,289
5948,011C,1759,65,209,6,11,0,291
5949,011C,1760,61,212,2,2,1,278
5950,011C,1761,62,222,2,3,0,289
5951,011C,1762,53,211,8,2,0,274
5952,011C,1763,59,207,3,3,0,272
5953,011C,1764,63,214,4,6,0,287
5954,011C,1765,67,221,0,5,0,293
5955,011C,1766,64,205,7,6,0,282
5956,011C,1767,75,204,1,3,0,283
5957,011C,1768,58,218,3,7,0,286
5958,011C,1769,58,212,6,8,0,284
5959,011C,1770,64,206,3,3,0,276
5960,011C,1771,70,203,1,6,0,280
5961,011C,1772,63,218,2,3,2,288
5962,011C,1773,64,216,3,3,0,286
5963,011C,1774,56,228,2,2,0,288
5964,011C,1775,46,228,3,4,0,281
5965,011C,1776,48,234,1,4,0,287
5966,011C,1777,53,207,4,5,0,269
5967,011C,1778,62,215,0,1,0,278
5968,011C,1779,65,204,0,9,0,278
5969,011C,1780,61,198,2,9,5,275
5970,011C,1781,52,227,2,9,0,290
5971,014I,3036,73,211,4,6,0,294
5972,014I,3037,71,228,9,2,0,310
5973,014I,3038,65,218,3,3,0,289
5974,014I,3039,50,236,2,6,0,294
5975,014I,3040,51,237,4,4,0,296
5976,014I,3041,59,211,7,6,0,283
5977,014I,3042,51,243,3,5,0,302
5978,014I,3043,50,227,5,5,0,287
5979,014I,3044,66,223,8,2,0,299
5980,014I,3045,65,215,7,0,0,287
5981,014I,3046,54,233,2,5,0,294
5982,014I,3047,51,241,0,2,0,294
5983,014I,3048,50,226,5,6,0,287
5984,014I,3049,54,225,1,2,0,282
5985,014I,3050,60,244,3,3,0,310
5986,009D,1069,60,221,0,4,0,285
5987,009D,1070,42,237,4,4,0,287
5988,009D,1071,45,239,1,4,0,289
5989,009D,1072,38,239,4,3,0,284
5990,009D,1073,56,223,2,3,0,284
5991,009D,1074,47,221,4,2,0,274
5992,009D,1075,58,223,4,2,0,287
5993,009D,1076,36,245,3,4,0,288
5994,009D,1077,52,231,6,0,0,289
5995,009D,1078,52,229,2,2,0,285
5996,009D,1079,53,228,3,2,0,286
5997,009D,1080,50,225,2,9,0,286
5998,009D,1081,49,226,7,0,0,282
5999,009D,1082,60,228,4,1,0,293
6000,009D,1083,45,223,2,4,0,274
6001,009D,1084,52,236,2,2,0,292
6002,009D,1085,55,219,1,1,0,276
6003,009D,1086,60,224,2,2,0,288
6004,009D,1087,43,242,0,2,0,287
6005,009D,1088,51,227,0,0,0,278
6006,009D,1089,52,223,4,3,0,282
6007,009D,1090,46,225,5,8,0,284
6008,009D,1091,0,0,0,0,0,0
6009,009D,1092,59,214,2,3,0,278
6010,009D,1093,67,217,1,3,0,288
6011,009D,1094,51,224,2,6,0,283
6012,009D,1095,40,224,4,6,0,274
6013,007C,739,2,7,0,0,0,9
6014,010G,1378,63,170,1,3,0,237
6015,010G,1379,86,169,4,4,0,263
6016,010G,1380,88,162,7,4,0,261
6017,010G,1381,79,176,4,1,0,260
6018,010G,1382,63,194,5,0,0,262
6019,010G,1383,58,204,0,5,0,267
6020,010G,1384,63,188,4,4,0,259
6021,010G,1385,53,197,7,2,0,259
6022,010G,1386,68,184,1,5,0,258
6023,010G,1387,66,164,4,5,0,239
6024,010G,1388,82,178,3,4,0,267
6025,010G,1389,61,195,4,4,0,264
6026,010G,1390,68,178,0,6,0,252
6027,010G,1391,69,177,6,6,0,258
6028,010G,1392,76,179,3,2,0,260
6029,010G,1393,84,167,4,3,0,258
6030,010G,1394,76,173,3,1,0,253
6031,010G,1395,77,171,3,6,0,257
6032,010G,1396,82,168,3,6,0,259
6033,010G,1397,71,199,2,5,1,278
6034,010G,1398,82,182,1,3,0,268
6035,010G,1399,64,190,0,2,0,256
6036,010G,1400,72,190,3,2,0,267
6037,010G,1401,76,170,9,0,0,255
6038,010G,1402,62,174,3,10,0,249
6039,010G,1403,67,175,4,7,0,253
6040,010G,1404,88,157,4,3,0,252
6041,010G,1405,83,161,4,2,0,250
6042,010G,1406,81,159,6,6,3,255
6043,010G,1407,58,192,3,5,0,258
6044,010G,1408,65,189,2,1,0,257
6045,010G,1409,78,182,2,3,1,266
6046,010G,1410,80,176,3,1,0,260
6047,010G,1411,81,181,4,6,0,272
6048,010G,1412,56,198,4,6,0,264
6049,010G,1413,54,198,3,0,0,255
6050,010G,1414,75,181,2,4,0,262
6051,010G,1415,65,176,2,8,0,251
6052,010G,1416,59,172,1,7,0,239
6053,010G,1417,63,191,1,4,0,259
6054,010G,1418,70,180,3,7,0,260
6055,010G,1419,85,176,2,6,0,269
6056,010G,1420,81,182,3,2,0,268
6057,010G,1421,70,181,3,5,0,259
6058,010G,1422,82,161,4,4,0,251
6059,010G,1423,62,192,7,4,0,265
6060,010G,1424,97,161,6,4,0,268
6061,010G,1425,71,173,0,1,0,245
6062,010G,1426,80,177,2,8,0,267
6063,010G,1427,81,189,1,3,0,274
6064,010G,1428,65,181,5,7,0,258
6065,010G,1429,66,181,6,4,0,257
6066,010G,1430,70,176,5,5,0,256
6067,010G,1431,59,180,6,3,1,249
6068,010G,1432,75,194,6,2,0,277
6069,010G,1433,72,180,3,4,0,259
6070,010G,1434,70,172,3,9,0,254
6071,010G,1435,74,187,3,1,0,265
6072,010G,1436,70,180,3,8,0,261
6073,010G,1437,73,184,2,3,0,262
6074,010G,1438,72,192,1,1,0,266
6075,010G,1439,70,191,5,4,1,271
6076,009A,989,61,203,3,5,0,272
6077,009A,990,39,223,1,1,0,264
6078,009A,991,59,206,5,4,0,274
6079,009A,992,64,196,2,4,0,266
6080,009A,993,59,202,6,2,0,269
6081,009A,994,49,203,2,4,0,258
6082,009A,995,42,223,1,0,1,267
6083,009A,996,42,204,4,3,0,253
6084,009A,997,52,206,2,1,0,261
6085,009A,998,55,211,2,4,0,272
6086,009A,999,54,218,0,5,0,277
6087,009A,1000,57,199,1,2,0,259
6088,009A,1001,47,215,2,0,0,264
6089,009A,1002,52,198,3,3,0,256
6090,009A,1003,72,187,3,5,0,267
6091,007A,653,71,177,2,6,0,256
6092,007A,654,89,169,2,1,0,261
6093,007A,655,77,178,2,3,0,260
6094,007A,656,69,180,4,7,0,260
6095,007A,657,86,158,4,6,0,254
6096,007A,658,78,173,3,2,0,256
6097,007A,659,71,179,3,5,0,258
6098,007A,660,91,168,2,7,0,268
6099,007A,661,76,188,1,9,0,274
6100,007A,662,82,165,3,5,0,255
6101,007A,663,79,170,3,5,0,257
6102,007A,664,0,0,0,0,0,0
6103,007A,665,85,174,0,4,0,263
6104,007A,666,80,172,3,5,0,260
6105,007A,667,70,200,1,0,0,271
6106,007A,668,59,199,5,3,0,266
6107,007A,669,84,161,5,5,0,255
6108,007A,670,85,170,0,7,0,262
6109,007A,671,63,197,6,4,0,270
6110,007A,672,102,161,1,2,0,266
6111,009C,1028,62,187,4,2,0,255
6112,009C,1029,81,192,1,5,0,279
6113,009C,1030,77,170,4,10,0,261
6114,009C,1031,54,209,2,1,0,266
6115,009C,1032,64,183,0,6,0,253
6116,009C,1033,72,192,6,5,0,275
6117,009C,1034,54,199,5,9,0,267
6118,009C,1035,54,210,0,1,0,265
6119,009C,1036,51,204,1,5,0,261
6120,009C,1037,55,199,2,4,1,261
6121,009C,1038,43,235,5,1,0,284
6122,009C,1039,54,212,4,3,0,273
6123,009C,1040,76,153,6,11,2,248
6124,009C,1041,62,194,1,7,0,264
6125,009C,1042,65,189,3,1,0,258
6126,009C,1043,52,209,1,4,0,266
6127,009C,1044,74,192,3,3,0,272
6128,009C,1045,37,214,5,6,0,262
6129,009C,1046,72,194,4,1,0,271
6130,009C,1047,53,201,4,6,3,267
6131,009C,1048,60,208,0,6,0,274
6132,009C,1049,54,212,1,8,0,275
6133,009C,1050,46,205,5,9,0,265
6134,009C,1051,50,210,1,5,0,266
6135,009C,1052,69,192,2,1,0,264
6136,009C,1053,58,197,4,5,0,264
6137,009C,1054,60,197,2,6,0,265
6138,009C,1055,70,189,1,3,0,263
6139,009C,1056,53,205,6,3,0,267
6140,009C,1057,72,199,0,4,0,275
6141,009C,1058,62,202,6,0,0,270
6142,009C,1059,50,205,3,7,0,265
6143,009C,1060,45,198,2,2,0,247
6144,009C,1061,56,211,0,5,0,272
6145,009C,1062,64,187,1,3,0,255
6146,009C,1063,57,213,4,4,0,278
6147,009C,1064,57,199,1,5,0,262
6148,009C,1065,47,216,1,7,0,271
6149,009C,1066,49,204,2,0,0,255
6150,009C,1067,59,198,0,4,0,261
6151,009C,1068,61,197,1,6,0,265
6152,005D,425,115,137,1,5,0,258
6153,005D,426,111,117,10,9,0,247
6154,005D,427,95,146,1,8,0,250
6155,005D,428,103,136,3,6,0,248
6156,005D,429,103,152,1,5,0,261
6157,005D,430,130,127,2,0,0,259
6158,005D,431,99,143,2,7,0,251
6159,005D,432,104,139,1,6,0,250
6160,005D,433,111,145,3,3,0,262
6161,005D,434,114,141,5,7,0,267
6162,005D,435,95,147,2,5,0,249
6163,005D,436,95,150,3,3,0,251
6164,005D,437,107,136,4,6,0,253
6165,005D,438,90,149,1,6,0,246
6166,005D,439,108,146,2,2,1,259
6167,005D,440,104,134,1,4,0,243
6168,005D,441,100,144,3,5,0,252
6169,005D,442,78,146,4,15,0,243
6170,005D,443,96,149,2,5,0,252
6171,005D,444,99,138,3,7,0,247
6172,005D,445,102,129,3,7,0,241
6173,005D,446,100,161,8,0,0,269
6174,005D,447,125,144,2,2,0,273
6175,005D,448,108,123,2,6,0,239
6176,005D,449,113,133,3,4,0,253
6177,005D,450,120,135,0,5,0,260
6178,005D,451,102,123,4,2,0,231
6179,005D,452,94,153,2,4,0,253
6180,005D,453,68,161,1,6,0,236
6181,005D,454,102,137,5,6,2,252
6182,005D,455,125,122,2,9,0,258
6183,005D,456,93,156,2,5,0,256
6184,006D,601,51,207,6,3,0,267
6185,006D,602,59,210,3,4,0,276
6186,006D,603,52,214,3,2,0,271
6187,006D,604,62,210,0,2,0,274
6188,006D,605,56,197,1,2,0,256
6189,006D,606,59,207,8,4,0,278
6190,006D,607,55,197,6,4,0,262
6191,006D,608,61,204,7,1,0,273
6192,006D,609,70,195,3,2,0,270
6193,006D,610,74,186,8,2,0,270
6194,006D,611,64,185,5,5,0,259
6195,006D,612,71,177,4,1,0,253
6196,006D,613,41,220,2,2,0,265
6197,006D,614,60,196,1,4,0,261
6198,006D,615,81,180,6,2,0,269
6199,006D,616,46,211,2,2,0,261
6200,006D,617,61,194,7,10,0,272
6201,006D,618,63,195,6,5,0,269
6202,006D,619,61,202,2,5,0,270
6203,006D,620,79,179,6,6,0,270
6204,006D,621,50,217,8,6,0,281
6205,009E,1096,58,198,5,4,0,265
6206,009E,1097,57,190,4,3,0,254
6207,009E,1098,55,185,6,6,0,252
6208,009E,1099,57,189,1,1,0,248
6209,009E,1100,57,200,8,2,0,267
6210,009E,1101,72,177,1,3,0,253
6211,009E,1102,67,174,5,2,0,248
6212,009E,1103,60,184,4,1,0,249
6213,009E,1104,63,176,5,3,0,247
6214,009E,1105,63,194,2,4,0,263
6215,009E,1106,57,182,3,5,0,247
6216,009E,1107,58,201,1,3,0,263
6217,009E,1108,65,197,3,2,0,267
6218,009E,1109,63,173,5,9,0,250
6219,009E,1110,64,184,5,2,0,255
6220,13,2429,50,198,0,5,0,253
6221,13,2430,58,207,2,3,0,270
6222,13,2431,46,217,3,3,0,269
6223,13,2432,58,219,2,4,0,283
6224,13,2433,48,223,4,2,0,277
6225,13,2434,68,198,1,2,1,270
6226,13,2435,42,224,2,2,0,270
6227,13,2436,46,213,1,2,0,262
6228,13,2437,81,196,3,7,0,287
6229,13,2438,59,206,4,3,0,272
6230,13,2439,53,201,3,10,4,271
6231,13,2440,47,214,5,2,0,268
6232,13,2441,49,222,3,2,0,276
6233,13,2442,59,196,1,5,0,261
6234,13,2443,64,187,3,3,0,257
6235,13,2444,46,221,2,1,0,270
6236,13,2445,61,195,0,4,0,260
6237,13,2446,61,188,0,3,0,252
6238,13,2447,34,206,4,13,0,257
6239,13,2448,48,222,2,4,0,276
6240,13,2449,54,216,2,1,0,273
6241,13,2450,43,206,4,9,9,271
6242,13,2451,67,195,2,4,0,268
6243,13,2452,67,207,5,2,0,281
6244,13,2453,45,220,2,8,0,275
6245,13,2454,38,228,4,6,0,276
6246,13,2455,70,211,4,1,0,286
6247,014L,3086,44,226,12,1,0,283
6248,014L,3087,35,246,2,2,0,285
6249,014L,3088,38,247,5,1,0,291
6250,014L,3089,54,213,4,5,1,277
6251,014L,3090,44,234,2,2,0,282
6252,014L,3091,54,226,5,1,0,286
6253,014L,3092,31,231,2,2,0,266
6254,014L,3093,53,216,1,1,0,271
6255,014L,3094,37,229,2,3,0,271
6256,014L,3095,60,209,4,0,0,273
6257,014L,3096,67,208,3,0,0,278
6258,014L,3097,42,212,3,1,1,259
6259,014L,3098,48,222,6,4,1,281
6260,014L,3099,50,221,0,6,0,277
6261,014L,3100,63,222,1,0,0,286
6262,014L,3101,42,229,3,1,0,275
6263,013B,2505,37,67,0,2,0,106
6264,009G,1156,54,187,2,2,0,245
6265,009G,1157,60,173,2,0,0,235
6266,009G,1158,53,196,2,3,0,254
6267,009G,1159,53,200,1,3,0,257
6268,009G,1160,66,194,1,6,0,267
6269,009G,1161,55,194,3,5,0,257
6270,009G,1162,53,198,3,2,0,256
6271,009G,1163,48,201,2,2,0,253
6272,009G,1164,49,219,3,1,0,272
6273,009G,1165,59,196,8,2,0,265
6274,009G,1166,48,197,4,4,0,253
6275,009G,1167,64,193,4,3,0,264
6276,009G,1168,39,210,3,3,0,255
6277,009G,1169,52,205,5,2,0,264
6278,009G,1170,45,221,1,3,0,270
6279,009G,1171,65,192,5,1,0,263
6280,009G,1172,47,224,1,0,0,272
6281,009G,1173,46,217,2,0,0,265
6282,007B,673,71,194,3,2,0,270
6283,007B,674,64,204,3,1,0,272
6284,007B,675,81,186,3,4,0,274
6285,007B,676,71,200,3,3,0,277
6286,007B,677,66,189,4,4,0,263
6287,007B,678,70,199,1,3,0,273
6288,007B,679,82,186,5,10,0,283
6289,007B,680,60,211,5,6,0,282
6290,007B,681,48,223,1,1,0,273
6291,007B,682,75,196,3,3,0,277
6292,007B,683,69,185,1,6,0,261
6293,007B,684,51,219,4,4,0,278
6294,007B,685,58,219,2,2,0,281
6295,007B,686,76,197,2,3,0,278
6296,007B,687,66,195,1,3,0,265
6297,007B,688,59,194,7,7,0,267
6298,007B,689,72,182,5,0,0,259
6299,007B,690,49,204,5,4,0,262
6300,007B,691,70,198,6,2,0,276
6301,007B,692,82,175,1,5,0,263
6302,007B,693,63,180,2,1,0,246
6303,007B,694,66,195,2,2,0,265
6304,007B,695,60,195,6,1,0,262
6305,007B,696,60,187,15,3,0,265
6306,007B,697,68,192,1,7,0,268
6307,007B,698,52,209,4,2,0,267
6308,007B,699,82,197,3,3,0,285
6309,007B,700,84,175,2,3,0,264
6310,007B,701,69,197,2,3,0,271
6311,007B,702,63,210,3,7,0,283
6312,007B,703,63,196,3,5,0,267
6313,007B,704,61,199,5,7,1,273
6314,007B,705,74,188,0,5,3,270
6315,007B,706,63,189,3,6,0,261
6316,007B,707,44,213,7,7,0,271
6317,007B,708,61,192,3,3,0,259
6318,007B,709,71,190,2,5,0,268
6319,007B,710,64,196,4,4,0,268
6320,007B,711,67,208,3,2,1,281
6321,007B,712,66,175,6,8,0,255
6322,007B,713,57,206,0,6,0,269
6323,007B,714,76,179,3,0,0,258
6324,007B,715,78,191,5,2,0,276
6325,007B,716,72,205,2,1,0,280
6326,007B,717,68,199,2,5,0,274
6327,007B,718,75,180,4,6,0,265
6328,007B,719,60,204,1,6,0,271
6329,007B,720,72,202,4,5,0,283
6330,007B,721,70,208,3,1,0,282
6331,007B,722,70,198,1,5,0,274
6332,007B,723,71,193,1,10,0,275
6333,007B,724,66,190,0,5,0,261
6334,007B,725,63,203,1,4,0,271
6335,007B,726,82,185,2,2,0,271
6336,007B,727,43,220,2,4,0,269
6337,007B,728,59,204,4,7,0,274
6338,007B,729,79,192,3,5,0,279
6339,007B,730,77,204,4,0,0,285
6340,007B,731,60,205,3,2,0,270
6341,007B,732,58,192,10,8,0,268
6342,007B,733,70,195,2,1,0,268
6343,007B,734,57,206,4,4,0,271
6344,007B,735,64,202,5,1,0,272
6345,007B,736,48,220,1,7,0,276
6346,007B,737,70,191,2,3,0,266
6347,007B,738,64,202,4,3,1,274
6348,012F,2303,68,211,1,3,0,283
6349,012F,2304,58,213,1,6,0,278
6350,012F,2305,71,209,3,0,0,283
6351,012F,2306,57,228,3,3,0,291
6352,012F,2307,63,211,2,2,0,278
6353,012F,2308,60,225,1,4,0,290
6354,012F,2309,66,219,2,1,0,288
6355,012F,2310,70,218,1,3,0,292
6356,012F,2311,64,204,6,4,0,278
6357,012F,2312,67,228,5,3,0,303
6358,012F,2313,67,207,1,8,0,283
6359,012F,2314,67,208,2,2,0,279
6360,012F,2315,50,220,13,6,0,289
6361,012F,2316,71,202,5,3,0,281
6362,012F,2317,53,241,0,1,0,295
6363,012F,2318,70,227,3,2,0,302
6364,012F,2319,89,205,0,0,0,294
6365,012F,2320,73,205,6,3,0,287
6366,012F,2321,60,218,2,3,0,283
6367,012F,2322,53,213,3,3,0,272
6368,012F,2323,87,193,3,1,0,284
6369,012F,2324,58,201,6,6,0,271
6370,012F,2325,70,206,2,9,0,287
6371,012F,2326,76,204,1,5,0,286
6372,012F,2327,71,201,1,9,0,282
6373,012F,2328,68,221,1,7,0,297
6374,012F,2329,53,212,3,5,0,273
6375,012F,2330,54,223,0,8,0,285
6376,012F,2331,64,213,0,6,0,283
6377,012F,2332,51,208,2,8,0,269
6378,012F,2333,60,214,1,3,0,278
6379,012F,2334,72,213,5,4,0,294
6380,012F,2335,56,221,4,1,0,282
6381,012F,2336,66,199,7,5,0,277
6382,012F,2337,59,205,3,6,0,273
6383,012F,2338,57,196,2,6,8,269
6384,012F,2339,68,209,1,1,1,280
6385,012F,2340,67,206,7,2,1,283
6386,012F,2341,58,211,1,10,0,280
6387,012F,2342,70,202,2,7,0,281
6388,012F,2343,71,207,3,3,0,284
6389,012F,2344,62,205,1,2,2,272
6390,012F,2345,51,226,2,5,0,284
6391,012F,2346,57,215,3,3,0,278
6392,012F,2347,47,237,0,2,0,286
6393,012F,2348,63,204,0,7,0,274
6394,012F,2349,67,212,4,2,0,285
6395,012F,2350,80,206,5,3,0,294
6396,012F,2351,48,228,1,3,0,280
6397,012F,2352,59,205,4,10,0,278
6398,012F,2353,72,198,4,8,0,282
6399,012F,2354,52,228,1,6,0,287
6400,012F,2355,63,207,3,8,0,281
6401,012F,2356,58,234,2,3,0,297
6402,012F,2357,56,228,2,6,0,292
6403,012F,2358,63,215,4,8,0,290
6404,012F,2359,55,217,8,0,0,280
6405,010D,1295,60,211,2,3,0,276
6406,010D,1296,64,209,7,2,0,282
6407,010D,1297,77,172,1,7,0,257
6408,010D,1298,84,194,3,6,0,287
6409,010D,1299,90,184,0,0,0,274
6410,010D,1300,59,219,0,5,0,283
6411,010D,1301,74,201,0,3,0,278
6412,010D,1302,84,192,1,0,0,277
6413,010D,1303,60,198,3,7,0,268
6414,010D,1304,59,204,1,7,0,271
6415,014K,3075,70,184,1,7,0,262
6416,014K,3076,60,203,3,4,0,270
6417,014K,3077,76,186,0,7,0,269
6418,014K,3078,72,183,4,2,0,261
6419,014K,3079,73,184,3,11,0,271
6420,014K,3080,55,205,2,12,0,274
6421,014K,3081,66,198,4,8,0,276
6422,014K,3082,73,203,5,5,0,286
6423,014K,3083,60,195,1,2,0,258
6424,014K,3084,69,194,2,7,0,272
6425,014K,3085,63,203,6,2,0,274
6426,005H,528,120,111,1,0,0,232
6427,005H,529,111,91,7,6,0,215
6428,005H,530,114,105,3,5,0,227
6429,005H,531,87,120,9,0,0,216
6430,005H,532,115,103,1,4,0,223
6431,005H,533,117,106,2,3,0,228
6432,014J,3051,41,242,1,1,0,285
6433,014J,3052,27,248,2,0,0,277
6434,014J,3053,48,242,4,1,0,295
6435,014J,3054,43,223,3,2,0,271
6436,014J,3055,40,236,5,1,0,282
6437,014J,3056,50,231,3,3,0,287
6438,014J,3057,43,237,2,1,0,283
6439,014J,3058,28,245,5,5,0,283
6440,014J,3059,41,237,4,0,0,282
6441,014J,3060,24,262,2,2,0,290
6442,014J,3061,47,225,1,1,0,274
6443,014J,3062,31,249,2,0,0,282
6444,014J,3063,63,214,6,0,0,283
6445,014J,3064,30,238,5,4,0,277
6446,014J,3065,43,232,5,0,0,280
6447,014J,3066,42,237,6,1,0,286
6448,014J,3067,47,239,1,2,0,289
6449,014J,3068,39,250,4,2,0,295
6450,014J,3069,35,250,1,1,0,287
6451,014J,3070,34,246,2,1,0,283
6452,014J,3071,37,232,8,3,0,280
6453,014J,3072,55,220,2,0,0,277
6454,014J,3073,51,224,5,1,0,281
6455,014J,3074,27,246,1,5,0,279
6456,004D,291,30,262,3,0,0,295
6457,004D,292,40,259,0,1,0,300
6458,004D,293,40,242,2,3,0,287
6459,004D,294,46,235,2,2,0,285
6460,004D,295,37,252,5,2,0,296
6461,004D,296,50,240,3,0,0,293
6462,014C,2925,55,226,1,4,0,286
6463,014C,2926,60,226,1,4,0,291
6464,014C,2927,66,193,3,4,0,266
6465,014C,2928,71,211,6,3,0,291
6466,014C,2929,69,216,3,4,0,292
6467,014C,2930,66,203,4,5,0,278
6468,014C,2931,75,196,0,4,0,275
6469,014C,2932,71,206,4,2,0,283
6470,014C,2933,59,208,5,7,1,280
6471,014C,2934,47,224,3,3,0,277
6472,014C,2935,60,224,3,3,0,290
6473,014C,2936,70,206,3,3,0,282
6474,014C,2937,60,220,3,4,0,287
6475,014C,2938,59,203,5,2,0,269
6476,014G,2998,66,202,2,0,3,273
6477,014G,2999,59,202,3,5,0,269
6478,014G,3000,62,205,4,4,0,275
6479,014G,3001,71,192,1,3,0,267
6480,014G,3002,69,190,2,5,0,266
6481,014G,3003,63,207,0,3,0,273
6482,014G,3004,68,194,5,6,0,273
6483,014G,3005,73,181,8,0,0,262
6484,014G,3006,67,194,2,6,0,269
6485,014G,3007,68,206,6,2,0,282
6486,014G,3008,75,183,2,4,0,264
6487,014G,3009,52,213,3,6,0,274
6488,014G,3010,76,167,2,8,0,253
6489,014G,3011,71,189,2,2,0,264
6490,014G,3012,66,206,4,3,0,279
6491,014G,3013,61,207,3,2,0,273
6492,014G,3014,77,172,1,10,0,260
6493,014G,3015,68,194,5,3,0,270
6494,014G,3016,77,191,2,4,2,276
6495,014G,3017,73,196,2,8,0,279
6496,014G,3018,64,207,4,3,0,278
6497,014G,3019,78,207,1,2,0,288
6498,014G,3020,80,177,1,4,0,262
6499,014G,3021,78,173,2,3,0,256
6500,014G,3022,70,200,3,3,0,276
6501,014G,3023,63,192,2,1,0,258
6502,014G,3024,78,187,1,1,0,267
6503,014B,2903,56,217,1,5,0,279
6504,014B,2904,65,207,5,2,0,279
6505,014B,2905,81,204,3,5,0,293
6506,014B,2906,66,207,2,3,0,278
6507,014B,2907,62,212,3,2,0,279
6508,014B,2908,52,213,4,6,0,275
6509,014B,2909,68,207,3,3,0,281
6510,014B,2910,59,230,5,1,0,295
6511,014B,2911,59,223,1,5,0,288
6512,014B,2912,61,216,2,6,0,285
6513,014B,2913,66,207,3,5,1,282
6514,014B,2914,81,207,2,3,0,293
6515,014B,2915,55,215,3,3,0,276
6516,014B,2916,65,211,1,1,0,278
6517,014B,2917,43,231,0,5,0,279
6518,014B,2918,60,199,4,8,0,271
6519,014B,2919,58,214,3,4,0,279
6520,014B,2920,59,220,3,0,0,282
6521,014B,2921,58,209,2,5,0,274
6522,014B,2922,61,196,4,3,0,264
6523,014B,2923,68,197,4,5,0,274
6524,014B,2924,65,199,1,7,0,272
6525,014A,2852,90,164,2,8,0,264
6526,014A,2853,98,149,4,3,0,254
6527,014A,2854,76,170,3,2,0,251
6528,014A,2855,106,153,5,3,0,267
6529,014A,2856,104,152,2,6,0,264
6530,014A,2857,111,133,1,6,0,251
6531,014A,2858,89,172,2,3,0,266
6532,014A,2859,105,165,1,3,0,274
6533,014A,2860,88,154,4,12,0,258
6534,014A,2861,114,141,5,3,0,263
6535,014A,2862,103,144,1,11,0,259
6536,014A,2863,98,167,2,4,0,271
6537,014A,2864,75,145,0,9,0,229
6538,014A,2865,83,164,3,6,0,256
6539,014A,2866,96,153,1,2,0,252
6540,014A,2867,94,152,1,8,0,255
6541,014A,2868,67,167,1,8,0,243
6542,014A,2869,70,174,1,3,0,248
6543,014A,2870,80,186,5,5,0,276
6544,014A,2871,71,167,5,7,0,250
6545,014A,2872,97,171,1,3,0,272
6546,014A,2873,97,161,1,3,0,262
6547,014A,2874,92,139,2,9,0,242
6548,014A,2875,94,170,1,2,0,267
6549,014A,2876,96,163,2,3,0,264
6550,014A,2877,100,153,5,4,0,262
6551,014A,2878,101,144,4,10,0,259
6552,014A,2879,111,155,5,2,0,273
6553,014A,2880,87,149,0,7,0,243
6554,014A,2881,101,157,3,6,0,267
6555,014A,2882,91,162,1,4,0,258
6556,014A,2883,102,151,0,3,0,256
6557,014A,2884,95,162,4,6,0,267
6558,014A,2885,91,177,2,3,0,273
6559,014A,2886,102,167,1,3,0,273
6560,014A,2887,91,144,10,6,0,251
6561,014A,2888,74,168,2,4,0,248
6562,014A,2889,108,154,2,2,1,267
6563,014A,2890,108,137,2,6,0,253
6564,014A,2891,100,152,1,6,0,259
6565,014A,2892,103,155,3,5,0,266
6566,014A,2893,105,144,1,5,0,255
6567,014A,2894,98,157,1,4,0,260
6568,014A,2895,109,120,1,1,0,231
6569,014A,2896,112,145,2,5,0,264
6570,014A,2897,0,0,0,0,0,0
6571,014A,2898,112,144,0,2,0,258
6572,014A,2899,109,150,0,10,0,269
6573,014A,2900,60,178,10,0,0,248
6574,014A,2901,103,156,5,0,0,264
6575,014A,2902,84,167,4,4,0,259
6576,1,1,59,170,5,4,0,238
6577,1,2,0,0,0,0,0,0
6578,1,3,57,187,6,3,0,253
6579,1,4,53,191,6,3,0,253
6580,1,5,63,193,3,1,1,261
6581,1,6,42,197,8,0,0,247
6582,1,7,57,199,3,4,0,263
6583,1,8,61,193,7,3,0,264
6584,1,9,59,187,7,0,2,255
6585,1,10,72,184,4,1,0,261
6586,1,11,43,190,4,4,0,241
6587,1,12,59,181,4,8,0,252
6588,1,13,56,194,4,1,0,255
6589,1,14,68,183,2,2,0,255
6590,1,15,47,180,3,2,0,232
6591,1,16,52,184,1,2,0,239
6592,1,17,52,178,4,2,0,236
6593,1,18,50,196,6,5,0,257
6594,1,19,59,195,3,1,0,258
6595,1,20,62,189,5,3,0,259
6596,1,21,57,174,6,1,0,238
6597,1,22,36,225,4,2,0,267
6598,1,23,47,176,3,2,0,228
6599,1,24,67,178,3,2,0,250
6600,1,25,51,195,7,3,0,256
6601,1,26,59,197,2,3,0,261
6602,1,27,48,189,12,3,0,252
6603,1,28,54,207,2,5,0,268
6604,1,29,50,203,3,6,0,262
6605,1,30,59,182,3,2,0,246
6606,1,31,58,198,6,1,0,263
6607,1,32,58,177,6,3,0,244
6608,1,33,62,181,5,3,1,252
6609,1,34,70,167,2,2,0,241
6610,1,35,61,179,4,3,0,247
6611,1,36,42,208,4,5,0,259
6612,1,37,61,187,1,1,0,250
6613,1,38,48,199,0,1,0,248
6614,1,39,50,206,2,4,0,262
6615,1,40,60,189,6,2,0,257
6616,1,41,48,182,5,0,0,235
6617,1,42,56,182,4,3,0,245
6618,1,43,54,185,6,1,0,246
6619,1,44,58,176,3,5,0,242
6620,1,45,62,193,4,3,0,262
6621,1,46,41,207,2,4,0,254
6622,5,311,61,199,1,5,0,266
6623,5,312,70,202,3,3,0,278
6624,5,313,62,214,2,3,0,281
6625,5,314,60,202,5,7,0,274
6626,5,315,55,215,5,0,0,275
6627,5,316,80,182,4,7,4,277
6628,5,317,72,186,3,15,1,277
6629,5,318,58,211,0,1,0,270
6630,5,319,56,197,2,3,0,258
6631,5,320,74,202,1,6,0,283
6632,5,321,61,200,1,5,0,267
6633,5,322,79,190,2,3,0,274
6634,5,323,73,191,1,1,0,266
6635,5,324,57,209,4,3,0,273
6636,5,325,54,220,0,3,0,277
6637,5,326,54,204,6,1,0,265
6638,5,327,64,190,0,4,0,258
6639,5,328,65,196,1,3,0,265
6640,5,329,62,218,4,4,0,288
6641,5,330,66,187,8,1,0,262
6642,5,331,64,198,3,1,0,266
6643,5,332,63,204,0,9,0,276
6644,5,333,55,202,4,1,0,262
6645,5,334,57,211,5,2,0,275
6646,5,335,71,204,4,5,0,284
6647,5,336,61,203,4,1,0,269
6648,5,337,56,221,3,5,0,285
6649,5,338,52,217,1,4,1,275
6650,5,339,58,199,4,3,0,264
6651,5,340,75,204,2,6,0,287
6652,5,341,56,200,5,5,0,266
6653,5,342,54,216,4,7,0,281
6654,5,343,54,193,4,5,0,256
6655,5,344,81,182,1,3,0,267
6656,5,345,54,214,4,4,0,276
6657,5,346,56,207,2,5,0,270
6658,5,347,54,215,5,3,0,277
6659,5,348,59,197,8,6,9,279
6660,5,349,75,204,1,1,0,281
6661,5,350,66,207,1,3,0,277
6662,010A,1225,68,210,3,11,0,292
6663,010A,1226,62,221,5,7,0,295
6664,010A,1227,65,213,3,16,0,297
6665,010A,1228,77,200,2,9,0,288
6666,010A,1229,71,193,1,7,0,272
6667,010A,1230,72,215,3,5,0,295
6668,010A,1231,53,210,0,14,0,277
6669,010A,1232,79,188,2,11,0,280
6670,010A,1233,62,213,3,8,0,286
6671,010A,1234,68,212,0,10,0,290
6672,010A,1235,78,209,6,4,0,297
6673,010A,1236,73,214,2,3,0,292
6674,010A,1237,82,190,2,16,0,290
6675,010A,1238,64,217,2,3,0,286
6676,012I,2422,130,114,2,6,0,252
6677,012I,2423,107,137,1,9,0,254
6678,012I,2424,136,104,3,0,0,243
6679,012I,2425,122,118,3,2,0,245
6680,012I,2426,143,121,0,9,0,273
6681,012I,2427,150,109,1,2,0,262
6682,012I,2428,131,136,2,6,0,275
6683,013K,2795,43,186,1,3,0,233
6684,013K,2796,24,225,1,2,0,252
6685,013K,2797,43,199,0,1,0,243
6686,013K,2798,40,201,0,2,0,243
6687,013K,2799,36,193,4,1,0,234
6688,013K,2800,39,188,0,4,0,231
6689,013K,2801,34,196,3,2,0,235
6690,6,548,52,172,4,7,0,235
6691,6,549,62,203,0,2,0,267
6692,6,550,43,208,2,3,0,256
6693,6,551,55,190,5,2,0,252
6694,6,552,65,184,0,4,0,253
6695,6,553,53,198,0,3,0,254
6696,6,554,66,188,5,4,0,263
6697,6,555,64,185,0,2,0,251
6698,6,556,70,179,1,4,0,254
6699,6,557,66,193,4,3,0,266
6700,6,558,73,173,3,5,0,254
6701,6,559,62,187,6,4,0,259
6702,6,560,48,194,3,6,0,251
6703,6,561,81,173,3,0,0,257
6704,6,562,53,185,2,1,0,241
6705,6,563,59,185,6,5,1,256
6706,005I,534,105,164,1,3,0,273
6707,005I,535,108,147,2,5,0,262
6708,005I,536,113,161,2,1,0,277
6709,005I,537,102,154,3,3,5,267
6710,005I,538,98,163,2,5,0,268
6711,005I,539,105,158,0,5,0,268
6712,005I,540,96,167,2,4,1,270
6713,005I,541,96,171,1,10,0,278
6714,005I,542,0,0,0,0,0,0
6715,005I,543,106,154,3,0,9,272
6716,005I,544,124,154,4,3,1,286
6717,005I,545,82,178,1,9,0,270
6718,005I,546,110,164,0,5,0,279
6719,005I,547,115,154,0,5,0,274
6720,009B,1004,46,216,5,2,0,269
6721,009B,1005,55,204,4,3,0,266
6722,009B,1006,48,214,5,3,0,270
6723,009B,1007,50,203,2,2,0,257
6724,009B,1008,54,222,4,1,0,281
6725,009B,1009,64,198,5,3,0,270
6726,009B,1010,60,210,1,1,0,272
6727,009B,1011,49,219,4,3,0,275
6728,009B,1012,61,206,3,1,0,271
6729,009B,1013,64,207,2,2,0,275
6730,009B,1014,49,206,1,5,0,261
6731,009B,1015,58,208,2,5,0,273
6732,009B,1016,57,210,1,2,0,270
6733,009B,1017,55,223,1,4,0,283
6734,009B,1018,48,212,5,4,0,269
6735,009B,1019,55,198,3,3,0,259
6736,009B,1020,55,192,2,5,0,254
6737,009B,1021,59,208,5,0,0,272
6738,009B,1022,52,213,2,2,0,269
6739,009B,1023,55,214,0,2,0,271
6740,009B,1024,49,215,1,1,1,267
6741,009B,1025,50,215,3,1,0,269
6742,009B,1026,57,199,1,7,0,264
6743,009B,1027,60,213,5,6,0,284
6744,013G,2582,61,193,1,5,0,260
6745,013G,2583,71,190,7,3,0,271
6746,013G,2584,62,186,5,12,0,265
6747,013G,2585,64,185,1,14,0,264
6748,013G,2586,58,197,2,6,0,263
6749,013G,2587,68,199,1,8,0,276
6750,013G,2588,46,238,2,4,0,290
6751,013G,2589,67,196,2,9,0,274
6752,013G,2590,76,204,4,10,0,294
6753,013G,2591,60,204,4,17,0,285
6754,013G,2592,60,205,4,3,0,272
6755,013G,2593,89,193,1,5,0,288
6756,013G,2594,81,188,0,4,0,273
6757,013G,2595,66,199,2,9,0,276
6758,013G,2596,54,201,0,10,0,265
6759,013G,2597,71,205,1,11,0,288
6760,013G,2598,64,208,0,2,0,274
6761,013G,2599,68,198,3,7,0,276
6762,013G,2600,55,206,0,4,0,265
6763,013G,2601,59,204,1,11,0,275
6764,013G,2602,54,214,5,11,0,284
6765,013G,2603,63,189,7,10,0,269
6766,013G,2604,69,186,2,10,0,267
6767,013G,2605,79,186,5,4,0,274
6768,013G,2606,69,201,2,5,0,277
6769,013G,2607,64,194,0,6,0,264
6770,013G,2608,71,191,2,13,0,277
6771,013G,2609,91,176,1,8,0,276
6772,013G,2610,62,196,1,10,0,269
6773,013G,2611,53,207,2,8,0,270
6774,013G,2612,90,179,6,0,0,275
6775,013G,2613,60,192,1,7,0,260
6776,013G,2614,71,170,1,5,1,248
6777,013G,2615,63,211,2,7,1,284
6778,013G,2616,66,191,1,8,0,266
6779,013G,2617,74,186,2,11,0,273
6780,013G,2618,49,218,0,8,0,275
6781,013G,2619,56,199,1,5,0,261
6782,013G,2620,65,181,0,10,0,256
6783,013G,2621,65,198,2,9,0,274
6784,013G,2622,94,182,8,0,0,284
6785,013G,2623,73,197,4,2,0,276
6786,013G,2624,78,184,8,0,0,270
6787,013G,2625,79,199,2,4,0,284
6788,013G,2626,72,202,3,9,0,286
6789,013G,2627,69,211,2,4,0,286
6790,013G,2628,67,195,4,4,0,270
6791,013G,2629,68,199,0,4,0,271
6792,013G,2630,58,204,5,7,0,274
6793,013G,2631,70,197,2,3,0,272
6794,013G,2632,65,195,3,7,0,270
6795,013G,2633,76,177,6,9,0,268
6796,013G,2634,74,206,5,6,0,291
6797,2,47,58,177,2,3,0,240
6798,2,48,65,174,4,4,0,247
6799,2,49,61,170,6,5,0,242
6800,2,50,55,186,3,2,0,246
6801,2,51,70,171,7,0,0,248
6802,2,52,60,173,5,2,0,240
6803,2,53,63,162,6,4,0,235
6804,2,54,80,175,5,7,0,267
6805,2,55,51,181,3,3,0,238
6806,2,56,62,172,4,3,0,241
6807,2,57,64,167,2,2,0,235
6808,2,58,59,173,3,2,1,238
6809,2,59,61,178,2,3,0,244
6810,2,60,71,149,6,9,0,235
6811,2,61,54,153,4,3,0,214
6812,2,62,51,184,3,5,0,243
6813,2,63,45,173,5,8,0,231
6814,004E,297,86,129,12,11,6,244
6815,004E,298,86,144,4,10,1,245
6816,004E,299,92,139,2,3,0,236
6817,004E,300,74,147,4,12,0,237
6818,004E,301,73,153,1,7,0,234
6819,004E,302,97,134,1,6,0,238
6820,004E,303,90,140,3,4,0,237
6821,010B,1239,59,213,3,14,0,289
6822,010B,1240,57,201,11,4,0,273
6823,010B,1241,48,215,3,8,0,274
6824,010B,1242,60,224,6,3,0,293
6825,010B,1243,63,218,3,4,0,288
6826,010B,1244,54,217,4,4,0,279
6827,010B,1245,60,227,3,1,0,291
6828,010B,1246,52,222,3,4,0,281
6829,010B,1247,64,209,6,0,0,279
6830,010B,1248,54,217,6,5,0,282
6831,010B,1249,52,217,5,4,0,278
6832,010B,1250,65,199,3,6,0,273
6833,010B,1251,53,230,7,3,0,293
6834,010B,1252,54,227,3,2,0,286
6835,010B,1253,50,216,4,4,0,274
6836,010B,1254,58,214,2,1,0,275
6837,010B,1255,74,205,2,6,0,287
6838,010B,1256,81,201,4,3,0,289
6839,010B,1257,55,207,4,6,0,272
6840,010B,1258,67,202,2,2,0,273
6841,010B,1259,57,215,2,4,0,278
6842,010B,1260,48,213,6,3,0,270
6843,010B,1261,49,225,6,2,0,282
6844,010B,1262,63,214,7,3,0,287
6845,010B,1263,42,237,1,1,1,282
6846,010B,1264,66,214,6,11,0,297
6847,010B,1265,72,204,1,3,0,280
6848,010B,1266,70,197,5,2,0,274
6849,010B,1267,74,203,7,3,0,287
6850,010B,1268,50,212,4,0,0,266
6851,010B,1269,52,223,1,3,0,279
6852,010B,1270,51,223,5,6,0,285
6853,010B,1271,72,193,1,1,0,267
6854,010B,1272,69,206,0,3,0,278
6855,010B,1273,51,226,8,5,0,290
6856,010B,1274,77,184,9,2,0,272
6857,010J,1505,63,202,5,3,0,273
6858,010J,1506,70,210,4,5,0,289
6859,010J,1507,69,209,2,1,0,281
6860,010J,1508,71,198,1,3,0,273
6861,010J,1509,51,219,4,6,0,280
6862,010J,1510,49,244,1,2,0,296
6863,010J,1511,61,199,4,5,0,269
6864,010J,1512,78,186,4,3,0,271
6865,010J,1513,64,203,1,3,6,277
6866,010J,1514,49,230,3,1,0,283
6867,010J,1515,70,208,4,4,0,286
6868,010J,1516,61,223,3,3,0,290
6869,010J,1517,54,220,6,6,0,286
6870,010J,1518,69,205,2,6,0,282
6871,010J,1519,78,200,1,6,0,285
6872,010J,1520,63,224,2,7,0,296
6873,010J,1521,64,214,2,3,0,283
6874,010J,1522,61,192,3,12,0,268
6875,010J,1523,92,192,2,4,0,290
6876,010J,1524,50,217,2,4,0,273
6877,010J,1525,79,186,1,3,0,269
6878,010J,1526,58,208,1,5,0,272
6879,010J,1527,67,189,1,2,0,259
6880,010J,1528,78,192,2,5,0,277
6881,010J,1529,57,202,2,2,0,263
6882,010J,1530,67,192,6,0,0,265
6883,010J,1531,61,203,4,3,1,272
6884,010J,1532,48,233,2,4,0,287
6885,010J,1533,60,221,2,2,0,285
6886,010J,1534,66,199,2,8,0,275
6887,010J,1535,66,204,2,7,0,279
6888,010J,1536,54,215,4,3,0,276
6889,010J,1537,69,203,5,3,0,280
6890,010J,1538,43,229,3,0,0,275
6891,010J,1539,70,204,3,4,0,281
6892,010J,1540,67,186,3,8,0,264
6893,145A,5058,100,94,4,1,0,199
6894,145,5056,91,81,0,2,0,174
6895,145,5057,81,88,1,2,0,172
6896,146B,5066,62,70,0,1,0,133
6897,146,5059,87,145,2,4,0,238
6898,146,5060,72,160,2,1,0,235
6899,146,5061,90,156,0,3,0,249
6900,146,5062,68,142,2,2,0,214
6901,146,5063,89,141,1,1,0,232
6902,146,5064,101,163,0,0,0,264
6903,144B,5055,11,7,0,0,0,18
6904,144A,5054,49,5,0,0,0,54
6905,146A,5065,62,113,7,3,0,185
6906,144,5051,121,76,2,0,0,199
6907,144,5052,142,54,4,0,0,200
6908,144,5053,140,42,2,1,0,185
6909,146C,5067,41,56,1,0,0,98
6910,227A,6315,83,90,0,0,0,173
6911,227A,6316,61,97,2,1,0,161
6912,225,6304,183,42,1,1,0,227
6913,225,6305,139,69,1,0,0,209
6914,225,6306,109,101,2,0,0,212
6915,225A,6307,17,13,0,0,0,30
6916,227C,6318,99,75,1,0,0,175
6917,229A,6343,34,122,1,0,0,157
6918,227B,6317,152,122,1,3,0,278
6919,228,6321,100,142,2,0,0,244
6920,228,6322,111,124,3,1,0,239
6921,228,6323,89,147,3,1,0,240
6922,228,6324,107,133,1,1,0,242
6923,228,6325,89,137,4,2,0,232
6924,228,6326,89,133,5,0,0,227
6925,228,6327,61,173,4,0,0,238
6926,228,6328,105,144,8,0,0,257
6927,227D,6319,74,49,0,0,9,132
6928,227D,6320,52,90,2,3,0,147
6929,226,6308,92,69,0,1,0,162
6930,226,6309,112,52,1,0,0,165
6931,229,6329,116,167,5,0,0,288
6932,229,6330,101,166,0,4,0,271
6933,229,6331,85,187,5,0,0,277
6934,229,6332,95,187,5,2,0,289
6935,229,6333,123,155,1,3,0,282
6936,229,6334,101,189,2,4,0,296
6937,229,6335,92,184,6,1,0,283
6938,229,6336,96,165,0,4,0,265
6939,229,6337,93,169,1,9,0,272
6940,229,6338,97,154,3,8,0,262
6941,229,6339,94,179,2,2,0,277
6942,229,6340,100,183,2,3,0,288
6943,229,6341,113,150,2,2,0,267
6944,229,6342,99,177,5,0,0,281
6945,227,6312,73,102,1,0,0,176
6946,227,6313,100,78,3,0,0,181
6947,227,6314,90,94,1,0,0,185
6948,223,6300,78,74,2,1,0,155
6949,223,6301,67,73,3,0,0,143
6950,223,6302,75,80,3,4,0,162
6951,226A,6310,101,52,0,0,0,153
6952,226A,6311,78,54,1,1,0,134
6953,224,6303,10,9,0,0,0,19
6954,291,7107,87,184,12,0,0,283
6955,291,7108,86,187,2,2,0,277
6956,291,7109,69,201,1,3,0,274
6957,291,7110,75,195,1,6,0,277
6958,291,7111,82,186,1,5,0,274
6959,291,7112,72,178,7,0,0,257
6960,291,7113,79,187,6,0,0,272
6961,291,7114,59,211,4,0,0,274
6962,291,7115,94,179,8,0,0,281
6963,291,7116,73,197,2,3,0,275
6964,291,7117,80,192,10,0,0,282
6965,291,7118,71,193,9,0,0,273
6966,291,7119,92,174,5,6,0,277
6967,291,7120,90,167,3,4,0,264
6968,291,7121,84,195,6,0,0,285
6969,291,7122,70,184,3,2,0,259
6970,291,7123,61,196,13,0,0,270
6971,291,7124,76,176,5,0,0,257
6972,310,7301,93,161,1,4,0,259
6973,310,7302,91,171,9,0,0,271
6974,310,7303,93,169,2,7,0,271
6975,310,7304,88,177,1,4,0,270
6976,310,7305,100,166,0,5,0,271
6977,310,7306,79,186,4,4,0,273
6978,310,7307,61,218,2,1,0,282
6979,310,7308,81,189,0,9,0,279
6980,310,7309,98,167,5,5,0,275
6981,310,7310,53,215,1,3,0,272
6982,310,7311,70,196,1,4,0,271
6983,310,7312,75,200,4,5,0,284
6984,310,7313,74,206,4,4,0,288
6985,310,7314,63,199,2,5,0,269
6986,310,7315,96,168,3,5,0,272
6987,310,7316,67,198,3,3,0,271
6988,310,7317,86,177,4,4,0,271
6989,310,7318,79,190,0,5,0,274
6990,310,7319,65,188,7,3,0,263
6991,310,7320,86,189,3,1,0,279
6992,310,7321,79,186,2,5,0,272
6993,310,7322,116,151,1,12,0,280
6994,310,7323,72,189,2,7,0,270
6995,310,7324,79,191,4,2,0,276
6996,310,7325,102,160,3,6,0,271
6997,310,7326,96,177,0,6,0,279
6998,310,7327,93,177,4,2,0,276
6999,310,7328,83,196,3,5,0,287
7000,310,7329,71,181,2,6,0,260
7001,310,7330,61,198,4,3,0,266
7002,310,7331,89,183,3,6,0,281
7003,310,7332,85,170,2,5,0,262
7004,310,7333,88,187,2,7,0,284
7005,310,7334,69,199,1,3,0,272
7006,310,7335,85,189,3,1,0,278
7007,310,7336,67,219,4,4,0,294
7008,310,7337,109,156,4,7,0,276
7009,310,7338,74,191,5,8,0,278
7010,310,7339,87,178,5,0,0,270
7011,310,7340,90,173,7,5,0,275
7012,310,7341,83,167,2,3,0,255
7013,310,7342,67,193,4,1,0,265
7014,310,7343,112,159,2,3,0,276
7015,310,7344,88,174,0,8,0,270
7016,310,7345,82,168,2,10,0,262
7017,310,7346,89,149,2,9,0,249
7018,310,7347,79,194,2,4,0,279
7019,310,7348,85,169,1,3,0,258
7020,310,7349,81,182,5,0,0,268
7021,310,7350,97,171,2,3,0,273
7022,310,7351,83,163,2,9,0,257
7023,310,7352,93,172,6,5,0,276
7024,310,7353,81,180,2,3,0,266
7025,310,7354,83,175,3,5,0,266
7026,310,7355,96,149,4,6,0,255
7027,310,7356,100,154,7,4,0,265
7028,310,7357,91,174,2,4,0,271
7029,310,7358,73,181,4,5,0,263
7030,310,7359,88,169,2,6,0,265
7031,310,7360,110,157,3,4,0,274
7032,310,7361,96,159,1,17,0,273
7033,310,7362,79,196,8,2,0,285
7034,310,7363,69,184,3,8,0,264
7035,310,7364,87,181,5,0,0,273
7036,310,7365,81,176,2,6,0,265
7037,310,7366,76,204,2,5,0,287
7038,310,7367,105,147,2,2,0,256
7039,310,7368,94,178,4,3,0,279
7040,310,7369,67,195,6,8,0,276
7041,310,7370,99,150,3,5,0,257
7042,310,7371,92,148,3,9,0,252
7043,310,7372,68,190,3,2,0,263
7044,310,7373,95,158,3,6,0,262
7045,310,7374,85,171,3,6,0,265
7046,310,7375,88,176,3,4,0,271
7047,310,7376,85,192,2,4,0,283
7048,310,7377,78,187,8,0,0,273
7049,310,7378,89,166,3,0,0,258
7050,310,7379,85,179,5,5,0,274
7051,310,7380,82,190,7,3,0,282
7052,310,7381,84,193,0,7,0,284
7053,277,6947,66,186,0,2,0,254
7054,277,6948,62,186,6,0,0,254
7055,277,6949,55,203,6,0,0,264
7056,277,6950,53,191,10,0,0,254
7057,277,6951,60,200,1,1,0,262
7058,277,6952,62,192,6,0,0,260
7059,277,6953,55,198,6,0,0,259
7060,277,6954,63,143,6,8,0,220
7061,277,6955,69,182,15,0,0,266
7062,304,7222,88,168,2,0,0,258
7063,304,7223,84,188,1,0,0,273
7064,304,7224,72,187,3,5,0,267
7065,304,7225,76,202,2,3,0,283
7066,304,7226,69,189,4,5,0,267
7067,304,7227,65,205,2,0,0,272
7068,304,7228,53,224,2,1,0,280
7069,304,7229,71,222,3,0,0,296
7070,304,7230,82,194,3,1,0,280
7071,304,7231,71,194,4,3,0,272
7072,304,7232,82,186,2,3,0,273
7073,304,7233,74,195,3,3,0,275
7074,304,7234,75,193,2,0,0,270
7075,304,7235,44,226,3,2,0,275
7076,304,7236,55,207,1,1,0,264
7077,304,7237,86,161,8,0,0,255
7078,304,7238,61,209,5,0,0,275
7079,304,7239,93,162,2,2,0,259
7080,304,7240,95,162,2,6,0,265
7081,304,7241,65,197,3,2,0,267
7082,304,7242,54,218,3,3,0,278
7083,304,7243,97,174,6,2,0,279
7084,304,7244,88,191,2,0,0,281
7085,304,7245,86,166,1,11,0,264
7086,304,7246,72,189,2,1,0,264
7087,304,7247,78,176,6,0,0,260
7088,304,7248,67,199,6,0,0,272
7089,304,7249,67,212,0,0,0,279
7090,304,7250,61,191,3,7,0,262
7091,304,7251,67,199,4,7,0,277
7092,304,7252,76,208,1,2,0,287
7093,304,7253,74,196,2,2,0,274
7094,304,7254,60,189,3,10,0,262
7095,304,7255,90,169,2,6,0,267
7096,304,7256,68,202,2,2,0,274
7097,304,7257,58,201,0,7,0,266
7098,304,7258,84,188,2,2,0,276
7099,304,7259,57,211,1,2,0,271
7100,304,7260,66,191,2,6,0,265
7101,304,7261,90,176,0,1,0,267
7102,304,7262,52,213,4,1,0,270
7103,304,7263,62,191,0,2,0,255
7104,304,7264,60,215,0,3,0,278
7105,304,7265,72,194,0,2,0,268
7106,304,7266,78,188,1,4,0,271
7107,304,7267,78,193,5,2,0,278
7108,307,7285,89,163,2,0,0,254
7109,307,7286,64,182,0,1,0,247
7110,309,7296,45,189,4,0,0,238
7111,309,7297,35,200,3,0,0,238
7112,309,7298,70,164,0,2,0,236
7113,309,7299,69,161,3,1,0,234
7114,309,7300,38,171,0,0,0,209
7115,291A,7125,6,58,2,0,0,66
7116,289,7097,89,146,1,0,0,236
7117,289,7098,91,151,2,0,0,244
7118,289,7099,87,156,0,5,0,248
7119,289,7100,103,137,2,1,0,243
7120,306,7283,80,144,1,0,0,225
7121,306,7284,59,164,2,2,0,227
7122,283A,7071,12,124,0,1,0,137
7123,300,7204,70,178,1,0,0,249
7124,300,7205,70,181,3,0,0,254
7125,300,7206,47,198,1,0,0,246
7126,300,7207,44,203,4,0,0,251
7127,292,7126,12,55,0,0,0,67
7128,288,7090,71,184,1,2,0,258
7129,288,7091,81,167,5,0,0,253
7130,288,7092,56,197,2,5,0,260
7131,288,7093,90,165,3,3,0,261
7132,288,7094,69,176,1,6,0,252
7133,288,7095,75,170,4,5,0,254
7134,281,7039,19,75,1,0,0,95
7135,308,7287,60,208,1,1,0,270
7136,308,7288,46,219,2,1,0,268
7137,308,7289,63,189,2,4,0,258
7138,308,7290,44,211,1,3,0,259
7139,308,7291,60,190,2,6,0,258
7140,308,7292,55,208,5,0,0,268
7141,308,7293,61,194,2,2,0,259
7142,308,7294,57,203,7,3,0,270
7143,308,7295,68,186,4,6,0,264
7144,298,7159,0,0,0,0,0,0
7145,298,7160,71,185,1,5,0,262
7146,298,7161,84,166,8,0,0,258
7147,298,7162,82,170,5,3,0,260
7148,298,7163,90,174,7,4,0,275
7149,298,7164,67,210,3,3,0,283
7150,298,7165,62,195,3,1,0,261
7151,298,7166,85,175,4,0,0,264
7152,298,7167,94,164,4,5,0,267
7153,298,7168,90,184,3,6,0,283
7154,298,7169,75,195,2,3,0,275
7155,298,7170,85,177,4,0,0,266
7156,298,7171,105,150,4,0,0,259
7157,298,7172,70,185,4,8,0,267
7158,298,7173,97,155,0,13,0,265
7159,298,7174,85,173,8,0,0,266
7160,298,7175,76,181,2,0,0,259
7161,298,7176,80,174,1,3,0,258
7162,298,7177,80,177,2,6,0,265
7163,298,7178,98,161,0,9,1,269
7164,298,7179,81,186,1,4,0,272
7165,298,7180,108,159,2,3,0,272
7166,298,7181,94,179,1,0,0,274
7167,298,7182,94,153,0,10,0,257
7168,298,7183,89,171,1,1,0,262
7169,298,7184,87,171,5,4,0,267
7170,298,7185,78,185,2,4,0,269
7171,298,7186,75,181,0,8,0,264
7172,298,7187,89,180,1,2,0,272
7173,298,7188,88,185,0,8,0,281
7174,298,7189,95,174,3,4,0,276
7175,298,7190,89,188,3,6,0,286
7176,298,7191,73,189,4,12,0,278
7177,298,7192,84,187,2,0,0,273
7178,298,7193,73,199,12,0,0,284
7179,298,7194,86,171,1,6,0,264
7180,298,7195,61,209,0,5,0,275
7181,298,7196,89,168,1,7,0,265
7182,298,7197,79,194,1,2,0,276
7183,298,7198,87,177,4,6,0,274
7184,298,7199,104,156,1,0,0,261
7185,298,7200,98,167,2,8,0,275
7186,298,7201,69,211,2,3,0,285
7187,283,7065,79,142,7,0,0,228
7188,283,7066,99,130,0,3,0,232
7189,283,7067,77,159,1,0,0,237
7190,283,7068,75,151,2,0,0,228
7191,283,7069,76,131,0,2,0,209
7192,283,7070,89,138,7,0,0,234
7193,279A,7020,37,99,2,0,0,138
7194,279A,7021,24,110,2,0,0,136
7195,285,7072,105,146,4,12,0,267
7196,285,7073,86,176,3,2,0,267
7197,285,7074,82,193,4,7,0,286
7198,285,7075,103,171,10,0,0,284
7199,285,7076,95,174,3,3,0,275
7200,285,7077,106,173,4,6,0,289
7201,285,7078,88,180,2,7,0,277
7202,285,7079,114,141,3,10,0,268
7203,285,7080,111,154,3,2,0,270
7204,285,7081,98,175,4,8,0,285
7205,285,7082,104,154,3,5,0,266
7206,285,7083,103,164,4,12,0,283
7207,285,7084,87,187,7,3,0,284
7208,285,7085,105,182,0,5,0,292
7209,285,7086,89,182,2,3,0,276
7210,285,7087,89,187,3,7,0,286
7211,296,7148,69,178,5,3,0,255
7212,296,7149,65,190,4,4,0,263
7213,296,7150,64,199,8,0,0,271
7214,296,7151,46,209,1,4,0,260
7215,296,7152,66,182,1,2,0,251
7216,296,7153,61,167,8,0,0,236
7217,296,7154,71,183,2,2,0,258
7218,295A,7147,18,171,0,0,0,189
7219,311,7461,35,153,1,4,0,193
7220,302,7214,9,59,0,0,0,68
7221,290,7101,56,178,0,2,0,236
7222,290,7102,57,182,2,4,0,245
7223,290,7103,67,197,2,2,0,268
7224,290,7104,58,176,4,3,0,241
7225,290,7105,61,187,2,4,0,254
7226,290,7106,70,164,2,0,0,236
7227,299,7202,30,122,0,0,0,152
7228,299,7203,36,104,0,0,0,140
7229,278,6956,86,168,1,6,0,261
7230,278,6957,59,188,0,7,0,254
7231,278,6958,81,171,2,4,0,258
7232,278,6959,69,175,0,2,1,247
7233,278,6960,93,145,2,3,0,243
7234,278,6961,83,152,3,7,0,245
7235,280,7022,70,183,7,0,0,260
7236,280,7023,72,184,3,0,0,259
7237,280,7024,0,0,0,0,0,0
7238,280,7025,67,184,5,0,0,256
7239,280,7026,73,165,3,5,0,246
7240,280,7027,70,179,2,3,0,254
7241,280,7028,53,198,5,0,0,256
7242,280,7029,60,194,2,4,0,260
7243,280,7030,65,180,2,3,0,250
7244,280,7031,82,163,0,2,0,247
7245,280,7032,67,185,0,3,0,255
7246,280,7033,80,167,1,9,0,257
7247,280,7034,87,166,3,3,0,259
7248,280,7035,57,205,2,2,0,266
7249,280,7036,87,157,3,5,0,252
7250,280,7037,64,183,1,0,0,248
7251,280,7038,54,194,2,3,0,253
7252,313,7463,82,174,2,3,0,261
7253,313,7464,68,192,4,5,0,269
7254,279,6962,55,210,2,3,0,270
7255,279,6963,68,209,1,6,0,284
7256,279,6964,56,215,0,12,0,283
7257,279,6965,62,211,0,2,0,275
7258,279,6966,50,212,7,0,0,269
7259,279,6967,53,227,4,0,0,284
7260,279,6968,46,225,2,3,0,276
7261,279,6969,36,253,3,0,0,292
7262,279,6970,47,237,3,6,0,293
7263,279,6971,35,258,0,2,0,295
7264,279,6972,56,228,1,2,0,287
7265,279,6973,39,251,1,5,0,296
7266,279,6974,59,223,3,0,0,285
7267,279,6975,71,217,0,2,0,290
7268,279,6976,47,218,1,8,0,274
7269,279,6977,47,210,2,3,0,262
7270,279,6978,50,228,1,4,0,283
7271,279,6979,92,193,1,1,0,287
7272,279,6980,56,233,1,3,0,293
7273,279,6981,52,225,3,7,0,287
7274,279,6982,48,214,8,4,0,274
7275,279,6983,46,207,6,0,0,259
7276,279,6984,46,225,1,3,0,275
7277,279,6985,49,236,1,2,0,288
7278,279,6986,40,221,2,3,0,266
7279,279,6987,69,198,4,4,0,275
7280,279,6988,53,227,2,7,0,289
7281,279,6989,58,201,6,0,0,265
7282,279,6990,64,215,1,9,0,289
7283,279,6991,62,205,0,5,0,272
7284,279,6992,61,210,2,1,0,274
7285,279,6993,90,196,1,3,0,290
7286,279,6994,43,238,1,2,0,284
7287,279,6995,36,221,2,6,0,265
7288,279,6996,42,225,2,3,0,272
7289,279,6997,56,225,1,2,0,284
7290,279,6998,31,239,1,4,0,275
7291,279,6999,44,223,2,4,0,273
7292,279,7000,73,198,2,8,0,281
7293,279,7001,64,206,2,10,0,282
7294,279,7002,61,219,0,4,0,284
7295,279,7003,54,209,0,6,0,269
7296,279,7004,75,194,0,4,0,273
7297,279,7005,42,233,1,4,0,280
7298,279,7006,41,230,1,3,0,275
7299,279,7007,78,194,4,5,0,281
7300,279,7008,58,225,1,3,0,287
7301,279,7009,58,215,3,6,0,282
7302,279,7010,68,199,1,2,0,270
7303,279,7011,38,231,2,4,0,275
7304,279,7012,44,229,6,0,0,279
7305,279,7013,51,236,1,4,0,292
7306,279,7014,60,211,1,1,0,273
7307,279,7015,46,222,0,3,0,271
7308,279,7016,47,228,1,4,0,280
7309,279,7017,59,207,3,0,0,269
7310,279,7018,71,208,1,2,0,282
7311,279,7019,50,227,2,4,0,283
7312,310A,7382,93,167,4,6,0,270
7313,310A,7383,80,209,5,1,0,295
7314,310A,7384,80,187,2,4,1,274
7315,310A,7385,73,191,0,0,0,264
7316,310A,7386,112,135,5,0,0,252
7317,310A,7387,90,175,9,0,0,274
7318,310A,7388,70,200,5,5,0,280
7319,310A,7389,56,195,3,5,0,259
7320,310A,7390,90,166,3,8,0,267
7321,310A,7391,66,205,1,3,0,275
7322,310A,7392,44,221,5,6,0,276
7323,310A,7393,60,215,3,2,0,280
7324,310A,7394,52,229,1,3,1,286
7325,310A,7395,64,200,0,6,0,270
7326,310A,7396,96,139,9,0,0,244
7327,310A,7397,80,193,5,2,0,280
7328,310A,7398,66,191,2,6,0,265
7329,310A,7399,85,180,3,2,0,270
7330,310A,7400,76,189,3,3,0,271
7331,310A,7401,78,183,1,4,0,266
7332,310A,7402,72,193,1,8,0,274
7333,310A,7403,72,181,4,6,0,263
7334,310A,7404,76,184,3,3,0,266
7335,310A,7405,68,196,3,4,0,271
7336,310A,7406,62,212,2,2,0,278
7337,310A,7407,99,164,4,4,0,271
7338,310A,7408,78,186,1,5,0,270
7339,310A,7409,73,204,2,2,0,281
7340,310A,7410,78,176,4,2,1,261
7341,310A,7411,78,199,4,0,0,281
7342,310A,7412,59,213,1,1,0,274
7343,310A,7413,106,161,1,4,0,272
7344,310A,7414,98,168,2,3,0,271
7345,310A,7415,76,194,4,3,0,277
7346,310A,7416,62,190,0,2,0,254
7347,310A,7417,56,226,1,6,0,289
7348,310A,7418,98,171,2,2,0,273
7349,310A,7419,73,188,1,3,0,265
7350,310A,7420,114,145,2,7,0,268
7351,310A,7421,96,181,4,0,0,281
7352,310A,7422,87,172,1,3,0,263
7353,310A,7423,68,204,7,0,0,279
7354,310A,7424,88,177,0,1,0,266
7355,310A,7425,92,184,2,2,0,280
7356,310A,7426,118,143,2,3,0,266
7357,310A,7427,96,156,3,8,0,263
7358,310A,7428,71,177,2,2,0,252
7359,310A,7429,75,193,3,1,0,272
7360,310A,7430,70,195,3,7,0,275
7361,310A,7431,60,215,1,0,0,276
7362,310A,7432,77,189,2,7,0,275
7363,310A,7433,74,178,3,3,0,258
7364,310A,7434,81,194,0,0,0,275
7365,310A,7435,74,183,3,3,0,263
7366,310A,7436,113,141,3,0,0,257
7367,310A,7437,89,181,3,3,0,276
7368,310A,7438,77,167,3,5,0,252
7369,310A,7439,101,158,3,3,0,265
7370,310A,7440,95,164,4,2,0,265
7371,310A,7441,59,198,2,4,0,263
7372,310A,7442,62,219,10,4,0,295
7373,310A,7443,66,191,2,1,0,260
7374,310A,7444,82,179,2,4,0,267
7375,310A,7445,82,190,1,1,0,274
7376,310A,7446,81,185,2,2,0,270
7377,310A,7447,93,176,1,2,0,272
7378,310A,7448,64,198,3,5,0,270
7379,310A,7449,86,179,4,5,0,274
7380,310A,7450,88,173,3,0,0,264
7381,310A,7451,65,204,3,3,0,275
7382,310A,7452,74,189,2,5,0,270
7383,310A,7453,77,165,1,8,0,251
7384,310A,7454,83,177,2,3,1,266
7385,310A,7455,66,202,3,9,0,280
7386,310A,7456,68,192,0,4,0,264
7387,310A,7457,65,199,1,0,0,265
7388,310A,7458,71,206,3,7,0,287
7389,310A,7459,89,170,1,5,0,265
7390,310A,7460,68,191,6,6,0,271
7391,286,7088,23,96,0,1,0,120
7392,295,7142,61,190,2,2,0,255
7393,295,7143,61,192,2,0,0,255
7394,295,7144,73,163,0,6,0,242
7395,295,7145,64,184,1,0,0,249
7396,295,7146,51,198,4,3,0,256
7397,288A,7096,49,82,1,0,0,132
7398,303,7215,88,160,0,1,0,249
7399,303,7216,68,161,6,5,0,240
7400,303,7217,100,127,2,3,0,232
7401,303,7218,73,151,1,2,0,227
7402,303,7219,83,157,4,1,0,245
7403,303,7220,93,138,1,5,0,237
7404,303,7221,76,145,1,5,0,227
7405,294A,7141,25,129,2,0,0,156
7406,294,7138,115,161,3,0,0,279
7407,294,7139,104,174,0,0,0,278
7408,294,7140,130,139,0,4,0,273
7409,287,7089,17,53,1,1,0,72
7410,314,7465,80,201,2,3,0,286
7411,314,7466,55,239,4,2,0,300
7412,314,7467,84,177,3,4,0,268
7413,314,7468,59,199,0,0,0,258
7414,314,7469,87,181,1,2,0,271
7415,314,7470,70,217,2,0,0,289
7416,314,7471,71,212,0,2,0,285
7417,314,7472,92,184,1,1,0,278
7418,314,7473,70,220,2,0,0,292
7419,297,7155,50,184,3,1,0,238
7420,297,7156,56,194,2,2,0,254
7421,297,7157,57,187,0,2,0,246
7422,297,7158,60,176,0,0,0,236
7423,305,7268,77,196,0,6,0,279
7424,305,7269,58,205,6,0,0,269
7425,305,7270,26,222,3,6,0,257
7426,305,7271,61,197,5,3,0,266
7427,305,7272,60,192,1,3,0,256
7428,305,7273,63,208,3,1,0,275
7429,305,7274,56,207,3,3,0,269
7430,305,7275,90,169,0,3,0,262
7431,305,7276,67,200,4,0,0,271
7432,305,7277,88,179,5,2,0,274
7433,305,7278,66,191,1,5,0,263
7434,305,7279,51,218,1,3,0,273
7435,305,7280,76,173,4,4,0,257
7436,305,7281,58,213,0,2,0,273
7437,305,7282,71,190,1,5,0,267
7438,293,7127,72,183,13,0,0,268
7439,293,7128,49,198,0,1,0,248
7440,293,7129,59,195,1,2,0,257
7441,293,7130,72,187,3,1,0,263
7442,293,7131,51,202,7,0,0,260
7443,293,7132,77,175,4,6,0,262
7444,293,7133,66,187,2,6,0,261
7445,293,7134,55,209,6,0,0,270
7446,293,7135,54,179,3,7,0,243
7447,293,7136,78,154,4,0,0,236
7448,293,7137,69,165,11,0,0,245
7449,301,7208,34,188,0,3,0,225
7450,301,7209,52,179,0,1,0,232
7451,301,7210,46,174,1,2,0,223
7452,301,7211,33,199,3,0,0,235
7453,301,7212,41,183,0,1,0,225
7454,301,7213,48,183,0,2,0,233
7455,315,7474,75,200,2,1,0,278
7456,315,7475,75,196,2,1,0,274
7457,312,7462,7,10,0,0,0,17
7458,282,7040,118,152,0,4,0,274
7459,282,7041,112,168,2,8,0,290
7460,282,7042,92,173,2,0,0,267
7461,282,7043,88,185,1,1,0,275
7462,282,7044,87,179,1,4,0,271
7463,282,7045,115,160,2,4,0,281
7464,282,7046,89,198,2,4,0,293
7465,282,7047,98,170,0,5,0,273
7466,282,7048,86,195,2,2,0,285
7467,282,7049,102,177,0,5,0,284
7468,282,7050,103,158,4,0,0,265
7469,282,7051,127,123,2,4,0,256
7470,282,7052,138,132,2,5,0,277
7471,282,7053,128,144,5,0,0,277
7472,282,7054,97,166,2,2,0,267
7473,282,7055,100,171,2,8,0,281
7474,282,7056,84,192,1,4,0,281
7475,282,7057,106,148,0,4,0,258
7476,282,7058,83,193,0,4,0,280
7477,282,7059,108,168,2,7,0,285
7478,282,7060,72,199,1,3,0,275
7479,282,7061,93,181,3,2,0,279
7480,282,7062,128,156,3,2,0,289
7481,282,7063,119,146,7,0,0,272
7482,282,7064,113,153,3,7,0,276
7483,351,8042,42,199,0,1,0,242
7484,351,8043,70,153,2,1,0,226
7485,351,8044,54,167,0,2,0,223
7486,351,8045,63,167,3,6,0,239
7487,352,8049,119,163,3,1,0,286
7488,352,8050,115,160,4,2,0,281
7489,352,8051,113,148,0,1,0,262
7490,352,8052,139,141,2,0,0,282
7491,352,8053,133,146,2,0,0,281
7492,357,8062,34,222,1,2,0,259
7493,357,8063,51,201,1,1,0,254
7494,357,8064,37,219,0,4,0,260
7495,357,8065,34,222,1,3,0,260
7496,357,8066,33,209,2,2,0,246
7497,357,8067,39,215,1,1,0,256
7498,356,8061,129,119,1,0,0,249
7499,353,8055,27,19,0,0,0,46
7500,358,8068,131,109,3,1,0,244
7501,358,8069,130,109,1,1,0,241
7502,351A,8046,57,118,4,0,0,179
7503,351A,8047,46,133,0,1,0,180
7504,351A,8048,44,139,0,0,0,183
7505,359,8070,93,189,1,4,0,287
7506,359,8071,66,225,1,5,0,297
7507,359,8072,67,210,1,3,0,281
7508,359,8073,85,185,4,1,0,275
7509,359,8074,48,219,1,1,0,269
7510,359,8075,67,211,1,2,0,281
7511,359,8076,60,208,5,0,0,273
7512,359,8077,69,196,4,1,0,270
7513,359,8078,88,188,1,3,0,280
7514,359,8079,62,223,2,0,0,287
7515,359,8080,85,201,2,3,0,291
7516,359,8081,55,219,1,3,0,278
7517,359,8082,80,193,1,3,0,277
7518,359,8083,60,217,1,1,0,279
7519,359,8084,94,169,4,4,0,271
7520,359,8085,55,225,4,5,0,289
7521,359,8086,83,203,1,2,0,289
7522,359,8087,93,184,0,2,0,279
7523,359,8088,94,162,4,7,0,267
7524,359,8089,84,183,1,2,0,270
7525,359,8090,72,217,1,3,0,293
7526,359,8091,79,203,1,3,0,286
7527,359,8092,70,219,1,1,0,291
7528,354,8056,68,68,5,4,0,145
7529,350,8040,15,141,0,1,0,157
7530,350,8041,22,135,1,0,0,158
7531,352A,8054,58,72,0,0,0,130
7532,355,8057,62,167,2,1,0,232
7533,355,8058,63,165,3,2,0,233
7534,355,8059,72,158,3,0,0,233
7535,355,8060,72,152,0,2,0,226
7536,387,8287,126,112,0,3,0,241
7537,387,8288,99,134,1,2,0,236
7538,387,8289,107,141,5,0,0,253
7539,387,8290,97,134,1,6,0,238
7540,387,8291,123,109,6,0,0,238
7541,390,8308,70,124,1,4,0,199
7542,390,8309,65,121,2,4,0,192
7543,402,8407,99,154,2,0,0,255
7544,402,8408,112,129,4,0,0,245
7545,402,8409,132,136,1,0,0,269
7546,402,8410,122,134,3,1,0,260
7547,402,8411,106,142,2,0,0,250
7548,391,8310,86,171,0,10,0,267
7549,391,8311,80,182,4,7,0,273
7550,391,8312,82,184,1,3,0,270
7551,391,8313,101,158,1,6,0,266
7552,391,8314,60,214,2,0,0,276
7553,391,8315,77,139,3,4,0,223
7554,391,8316,99,174,5,0,0,278
7555,391,8317,82,191,0,4,0,277
7556,391,8318,84,180,2,0,0,266
7557,391,8319,83,185,1,0,0,269
7558,391,8320,88,187,0,3,0,278
7559,391,8321,69,184,5,0,0,258
7560,391,8322,92,186,1,4,0,283
7561,391,8323,98,172,8,0,0,278
7562,391,8324,90,177,5,2,0,274
7563,391,8325,78,186,4,0,0,268
7564,391,8326,112,146,0,0,0,258
7565,391,8327,81,183,2,4,0,270
7566,391,8328,102,170,2,2,0,276
7567,391,8329,79,189,4,0,0,272
7568,377,8245,65,127,2,3,0,197
7569,381,8270,82,170,2,7,0,261
7570,381,8271,106,149,4,0,0,259
7571,381,8272,91,155,2,2,0,250
7572,381,8273,87,148,3,5,0,243
7573,384,8276,149,113,3,0,0,265
7574,384,8277,121,132,4,3,0,260
7575,384,8278,107,144,1,4,0,256
7576,384,8279,133,124,3,0,0,260
7577,384,8280,123,128,3,0,0,254
7578,397,8392,46,186,1,0,0,233
7579,397,8393,64,159,2,0,0,225
7580,397,8394,51,144,7,0,0,202
7581,397,8395,42,171,6,0,0,219
7582,397,8396,78,148,1,3,0,230
7583,394,8354,87,184,0,3,0,274
7584,394,8355,84,186,2,3,0,275
7585,394,8356,73,198,6,5,0,282
7586,394,8357,94,164,2,3,0,263
7587,394,8358,85,185,4,0,0,274
7588,394,8359,115,141,9,0,0,265
7589,394,8360,69,179,3,6,0,257
7590,385,8281,93,184,7,4,0,288
7591,385,8282,116,158,10,0,0,284
7592,385,8283,79,190,2,8,0,279
7593,385,8284,70,204,4,3,0,281
7594,378,8246,91,151,2,2,0,246
7595,378,8247,84,171,1,2,0,258
7596,378,8248,86,168,1,3,0,258
7597,378,8249,58,203,1,3,0,265
7598,378,8250,71,175,0,3,0,249
7599,378,8251,78,174,2,1,0,255
7600,378,8252,55,194,0,0,0,249
7601,378,8253,76,179,3,1,0,259
7602,378,8254,82,164,2,1,0,249
7603,378,8255,81,179,5,0,0,265
7604,378,8256,64,183,4,0,0,251
7605,378,8257,90,150,2,8,0,250
7606,378,8258,74,177,4,4,0,259
7607,378,8259,71,163,6,0,0,240
7608,378,8260,72,179,6,0,0,257
7609,378,8261,74,181,4,3,0,262
7610,378,8262,98,131,0,3,0,232
7611,378,8263,76,171,1,2,0,250
7612,378,8264,80,170,4,1,0,255
7613,378,8265,70,190,0,2,0,262
7614,378,8266,78,181,2,2,0,263
7615,378,8267,77,177,0,2,0,256
7616,378,8268,76,172,6,2,0,256
7617,389,8292,78,169,13,0,0,260
7618,389,8293,95,178,6,0,0,279
7619,389,8294,79,182,14,0,0,275
7620,389,8295,95,154,6,0,0,255
7621,389,8296,75,183,6,0,0,264
7622,389,8297,87,162,7,0,0,256
7623,389,8298,91,163,6,0,0,260
7624,389,8299,77,182,3,5,0,267
7625,389,8300,63,173,10,0,0,246
7626,389,8301,77,178,14,0,0,269
7627,389,8302,103,150,5,4,1,263
7628,389,8303,91,157,7,0,0,255
7629,389,8304,83,168,2,5,0,258
7630,389,8305,113,155,1,1,0,270
7631,389,8306,119,140,4,4,0,267
7632,389,8307,86,171,5,0,0,262
7633,396,8369,76,193,4,0,0,273
7634,396,8370,63,186,14,0,0,263
7635,396,8371,52,205,3,5,0,265
7636,396,8372,66,180,5,0,0,251
7637,396,8373,58,203,0,1,0,262
7638,396,8374,66,176,4,5,0,251
7639,396,8375,66,193,2,0,0,261
7640,396,8376,84,178,3,4,0,269
7641,396,8377,92,168,4,0,0,264
7642,396,8378,58,193,6,0,0,257
7643,396,8379,61,198,6,0,0,265
7644,396,8380,60,196,3,0,0,259
7645,396,8381,40,230,4,0,0,274
7646,396,8382,50,202,7,0,0,259
7647,396,8383,0,0,0,0,0,0
7648,396,8384,72,179,1,2,0,254
7649,396,8385,56,207,4,1,0,268
7650,396,8386,72,215,1,3,0,291
7651,396,8387,61,201,3,0,0,265
7652,396,8388,75,189,6,0,0,270
7653,396,8389,64,205,3,0,0,272
7654,396,8390,58,206,5,0,0,269
7655,376,8243,84,96,1,0,0,181
7656,376,8244,98,87,1,0,0,186
7657,374,8152,140,141,3,0,0,284
7658,374,8153,143,132,6,0,0,281
7659,400,8398,103,171,5,5,0,284
7660,400,8399,65,202,2,1,0,270
7661,400,8400,58,215,0,6,0,279
7662,400,8401,87,189,0,1,0,277
7663,400,8402,89,162,4,2,0,257
7664,400,8403,66,199,5,1,0,271
7665,400,8404,73,202,3,5,0,283
7666,400,8405,72,201,2,4,0,279
7667,401,8406,20,138,0,0,0,158
7668,373,8141,126,147,10,0,0,283
7669,373,8142,108,172,4,0,0,284
7670,373,8143,122,144,9,0,0,275
7671,373,8144,137,148,3,3,0,291
7672,373,8145,94,173,14,0,0,281
7673,373,8146,132,130,2,5,0,269
7674,373,8147,122,149,4,4,0,279
7675,373,8148,109,159,5,2,0,275
7676,373,8149,125,154,5,0,0,284
7677,373,8150,132,132,6,0,0,270
7678,373,8151,116,153,7,0,0,276
7679,396A,8391,6,23,0,0,0,29
7680,379,8269,4,5,0,1,0,10
7681,372,8136,114,105,2,2,0,223
7682,372,8137,127,107,2,0,0,236
7683,372,8138,114,103,5,2,0,224
7684,372,8139,136,89,2,1,0,228
7685,395,8361,73,179,4,0,0,256
7686,395,8362,73,171,9,0,0,253
7687,395,8363,72,171,3,2,0,248
7688,395,8364,72,180,3,3,0,258
7689,395,8365,89,170,0,1,0,260
7690,395,8366,84,159,3,0,0,246
7691,395,8367,76,173,3,0,0,252
7692,395,8368,80,171,2,0,0,253
7693,372A,8140,26,89,1,1,0,117
7694,392,8330,100,160,1,6,0,267
7695,392,8331,92,173,3,2,0,270
7696,392,8332,136,139,3,1,0,279
7697,392,8333,114,140,6,4,0,264
7698,392,8334,121,127,6,4,0,258
7699,392,8335,129,132,7,3,0,271
7700,392,8336,98,159,8,5,0,270
7701,392,8337,105,155,2,3,0,265
7702,392,8338,131,130,10,0,0,271
7703,392,8339,110,133,5,8,0,256
7704,397A,8397,0,6,0,0,0,6
7705,375,8154,52,198,2,2,0,254
7706,375,8155,69,179,1,3,0,252
7707,375,8156,64,187,3,6,0,260
7708,375,8157,65,208,1,1,0,275
7709,375,8158,61,198,0,3,0,262
7710,375,8159,36,214,0,2,0,252
7711,375,8160,68,184,3,4,0,259
7712,375,8161,89,164,1,0,0,254
7713,375,8162,67,177,2,2,0,248
7714,375,8163,61,197,3,3,0,264
7715,375,8164,67,207,2,3,0,279
7716,375,8165,63,179,0,6,0,248
7717,375,8166,48,206,0,5,0,259
7718,375,8167,80,175,0,7,0,262
7719,375,8168,79,180,3,5,0,267
7720,375,8169,70,195,0,4,3,272
7721,375,8170,49,205,1,6,0,261
7722,375,8171,76,168,0,4,0,248
7723,375,8172,79,166,2,4,0,251
7724,375,8173,72,184,3,2,0,261
7725,375,8174,51,204,1,2,0,258
7726,375,8175,73,187,2,1,0,263
7727,375,8176,68,185,2,0,0,255
7728,375,8177,63,203,2,12,1,281
7729,375,8178,70,181,2,2,0,255
7730,375,8179,77,165,4,5,0,251
7731,375,8180,56,190,1,2,0,249
7732,375,8181,78,161,1,2,0,242
7733,375,8182,76,184,4,4,0,268
7734,375,8183,61,197,0,4,0,262
7735,375,8184,63,176,5,2,0,246
7736,375,8185,57,184,2,5,0,248
7737,375,8186,59,198,1,2,0,260
7738,375,8187,67,192,1,0,0,260
7739,375,8188,67,172,7,0,1,247
7740,375,8189,61,176,6,5,0,248
7741,375,8190,61,208,2,2,0,273
7742,375,8191,77,184,1,2,0,264
7743,375,8192,82,148,0,6,0,236
7744,375,8193,84,155,3,1,0,243
7745,375,8194,65,166,4,3,0,238
7746,375,8195,75,162,3,4,0,244
7747,375,8196,61,191,2,2,0,256
7748,375,8197,68,171,2,2,0,243
7749,375,8198,67,198,3,4,0,272
7750,375,8199,57,205,1,4,0,267
7751,375,8200,89,163,3,10,0,265
7752,375,8201,65,163,1,2,0,231
7753,375,8202,63,202,1,4,0,270
7754,375,8203,58,201,3,2,0,264
7755,375,8204,84,165,5,0,0,254
7756,375,8205,73,192,4,2,0,271
7757,375,8206,65,187,3,2,0,257
7758,375,8207,87,171,0,12,0,270
7759,375,8208,51,181,4,3,0,239
7760,375,8209,91,151,1,3,0,246
7761,375,8210,82,165,1,5,0,253
7762,375,8211,66,188,2,4,0,260
7763,375,8212,66,190,1,1,0,258
7764,375,8213,60,193,6,2,0,261
7765,375,8214,71,190,1,6,0,268
7766,375,8215,79,172,5,5,0,261
7767,375,8216,68,187,4,3,0,262
7768,375,8217,79,167,1,5,0,252
7769,375,8218,47,220,6,7,0,280
7770,375,8219,61,185,5,10,0,261
7771,375,8220,38,219,2,3,0,262
7772,375,8221,63,177,2,0,0,242
7773,375,8222,77,172,5,1,0,255
7774,375,8223,85,168,1,6,0,260
7775,375,8224,71,187,0,4,0,262
7776,375,8225,70,178,2,3,0,253
7777,375,8226,85,171,2,4,0,262
7778,375,8227,77,189,2,3,0,271
7779,375,8228,54,203,14,0,0,271
7780,375,8229,72,187,3,2,0,264
7781,375,8230,61,186,5,3,0,255
7782,375,8231,78,179,3,3,0,263
7783,375,8232,59,196,6,1,0,262
7784,375,8233,66,186,1,3,0,256
7785,375,8234,71,191,4,1,0,267
7786,375,8235,62,176,3,7,0,248
7787,375,8236,81,171,3,3,0,258
7788,375,8237,54,207,4,4,0,269
7789,375,8238,91,163,1,5,0,260
7790,375,8239,67,179,2,3,0,251
7791,375,8240,108,148,2,5,0,263
7792,375,8241,65,197,0,2,0,264
7793,375,8242,56,219,3,2,0,280
7794,386,8285,150,88,1,2,0,241
7795,386,8286,137,96,2,7,0,242
7796,393,8340,87,165,6,0,0,258
7797,393,8341,102,158,0,5,0,265
7798,393,8342,100,155,4,0,0,259
7799,393,8343,93,180,7,0,0,280
7800,393,8344,98,149,7,0,0,254
7801,393,8345,71,189,6,0,0,266
7802,393,8346,86,178,3,0,0,267
7803,393,8347,118,153,3,5,0,279
7804,393,8348,90,163,4,0,0,257
7805,393,8349,119,145,0,0,0,264
7806,393,8350,70,186,5,0,0,261
7807,393,8351,66,195,2,0,0,263
7808,393,8352,87,179,3,0,0,269
7809,393,8353,91,166,2,4,0,263
7810,382,8274,85,133,1,6,0,225
7811,382,8275,72,166,0,3,0,241
7812,316D,7612,67,107,6,2,0,182
7813,316D,7613,61,116,3,0,0,180
7814,327,7714,49,161,0,0,0,210
7815,327,7715,39,167,2,0,0,208
7816,330,7724,86,174,0,3,0,263
7817,330,7725,73,172,0,2,0,247
7818,326C,7708,82,160,2,3,0,247
7819,326C,7709,80,170,1,4,0,255
7820,326C,7710,92,152,3,3,0,250
7821,326C,7711,82,158,3,6,0,249
7822,326C,7712,72,171,2,4,0,249
7823,326C,7713,82,159,2,5,0,248
7824,330A,7726,72,128,2,1,0,203
7825,330A,7727,53,128,1,3,0,185
7826,318,7640,58,201,4,1,0,264
7827,318,7641,56,199,1,1,0,257
7828,316G,7621,89,181,0,8,0,278
7829,316G,7622,111,160,1,10,1,283
7830,316G,7623,84,168,2,7,0,261
7831,316G,7624,93,169,0,10,0,272
7832,324,7666,88,154,6,7,0,255
7833,324,7667,61,193,3,1,0,258
7834,324,7668,80,165,6,2,0,253
7835,324,7669,62,180,3,6,0,251
7836,316A,7598,76,185,2,4,0,267
7837,316A,7599,90,181,4,8,5,288
7838,316A,7600,86,175,3,8,0,272
7839,316A,7601,76,195,2,5,1,279
7840,316A,7602,88,185,4,5,0,282
7841,316A,7603,85,185,3,4,0,277
7842,316A,7604,73,197,3,5,0,278
7843,316A,7605,80,189,0,6,0,275
7844,316A,7606,89,171,2,6,0,268
7845,316A,7607,90,188,0,0,0,278
7846,316A,7608,94,168,0,3,0,265
7847,316A,7609,77,187,2,1,0,267
7848,316J,7631,65,194,5,12,0,276
7849,316J,7632,66,198,5,6,0,275
7850,316J,7633,57,181,2,11,0,251
7851,316J,7634,69,184,7,2,0,262
7852,316J,7635,76,178,3,5,0,262
7853,316J,7636,64,200,4,7,0,275
7854,316J,7637,73,187,2,12,0,274
7855,316J,7638,71,185,1,6,0,263
7856,328,7716,74,182,0,1,0,257
7857,328,7717,70,175,3,3,0,251
7858,328,7718,41,204,1,3,0,249
7859,328,7719,61,169,3,4,0,237
7860,326,7675,62,211,1,6,0,280
7861,326,7676,69,194,1,3,0,267
7862,326,7677,71,201,0,4,0,276
7863,326,7678,65,186,3,6,0,260
7864,326,7679,76,206,1,2,0,285
7865,326,7680,55,207,0,6,0,268
7866,326,7681,65,212,0,5,0,282
7867,326,7682,90,181,3,7,0,281
7868,326,7683,49,219,5,7,0,280
7869,326,7684,69,186,2,6,0,263
7870,326,7685,78,193,2,3,0,276
7871,326,7686,69,197,1,7,0,274
7872,326,7687,63,228,1,1,0,293
7873,326,7688,78,190,0,3,0,271
7874,326,7689,58,210,2,6,0,276
7875,326,7690,71,194,2,3,0,270
7876,326,7691,63,187,1,10,0,261
7877,326,7692,74,198,1,4,0,277
7878,326,7693,62,208,3,4,0,277
7879,326,7694,67,205,0,4,0,276
7880,326,7695,79,193,2,2,0,276
7881,323,7649,62,206,7,0,0,275
7882,323,7650,71,186,1,10,0,268
7883,323,7651,69,217,1,5,0,292
7884,323,7652,56,202,3,4,0,265
7885,323,7653,68,202,0,4,0,274
7886,323,7654,71,212,2,3,0,288
7887,323,7655,79,177,2,2,0,260
7888,323,7656,69,203,3,1,0,276
7889,323,7657,59,207,3,0,0,269
7890,323,7658,66,213,5,0,0,284
7891,323,7659,55,212,1,8,0,276
7892,323,7660,73,191,9,0,0,273
7893,323,7661,46,207,2,5,0,260
7894,323,7662,45,214,2,1,0,262
7895,323,7663,53,213,7,0,0,273
7896,323,7664,60,204,4,8,0,276
7897,323,7665,73,196,1,11,0,281
7898,316H,7625,70,207,2,3,0,282
7899,316H,7626,68,199,5,1,2,275
7900,316H,7627,80,194,3,3,1,281
7901,319,7642,68,174,0,6,0,248
7902,319,7643,75,172,0,2,0,249
7903,319,7644,59,183,2,1,0,245
7904,319,7645,71,164,0,1,0,236
7905,319,7646,89,159,0,0,0,248
7906,317,7639,74,175,1,0,0,250
7907,326B,7704,79,214,0,1,0,294
7908,326B,7705,60,236,4,4,0,304
7909,326B,7706,68,232,1,3,0,304
7910,326B,7707,69,215,3,8,0,295
7911,316E,7614,63,169,2,2,0,236
7912,316E,7615,64,172,0,4,0,240
7913,316E,7616,56,116,0,8,0,180
7914,316E,7617,67,166,0,11,0,244
7915,322,7648,3,22,0,0,0,25
7916,316,7476,63,210,2,9,0,284
7917,316,7477,57,208,6,10,0,281
7918,316,7478,79,183,2,5,0,269
7919,316,7479,74,207,2,6,0,289
7920,316,7480,78,211,1,3,0,293
7921,316,7481,71,202,3,7,0,283
7922,316,7482,52,209,3,6,0,270
7923,316,7483,65,206,0,4,0,275
7924,316,7484,64,213,2,5,0,284
7925,316,7485,50,214,4,5,0,273
7926,316,7486,65,191,1,16,0,273
7927,316,7487,67,21,2,8,0,98
7928,316,7488,72,180,4,4,0,260
7929,316,7489,42,238,2,5,0,287
7930,316,7490,63,207,2,4,0,276
7931,316,7491,61,201,2,4,0,268
7932,316,7492,66,198,2,15,0,281
7933,316,7493,57,189,8,5,0,259
7934,316,7494,72,212,4,4,0,292
7935,316,7495,51,207,4,5,0,267
7936,316,7496,63,199,0,10,0,272
7937,316,7497,57,191,3,18,0,269
7938,316,7498,72,188,3,5,0,268
7939,316,7499,70,188,2,6,0,266
7940,316,7500,69,209,1,3,0,282
7941,316,7501,63,205,1,7,0,276
7942,316,7502,63,194,0,4,0,261
7943,316,7503,74,186,5,5,0,270
7944,316,7504,89,171,4,0,0,264
7945,316,7505,82,187,4,7,0,280
7946,316,7506,67,214,3,2,0,286
7947,316,7507,71,183,5,14,0,273
7948,316,7508,76,200,1,5,0,282
7949,316,7509,48,200,2,10,7,267
7950,316,7510,64,200,6,3,0,273
7951,316,7511,51,225,8,0,0,284
7952,316,7512,71,206,2,2,0,281
7953,316,7513,77,203,6,3,0,289
7954,316,7514,72,179,12,9,0,272
7955,316,7515,73,187,5,10,0,275
7956,316,7516,57,204,3,7,0,271
7957,316,7517,62,210,3,11,0,286
7958,316,7518,64,195,4,3,0,266
7959,316,7519,65,215,2,10,0,292
7960,316,7520,66,206,2,4,0,278
7961,316,7521,82,175,2,14,0,273
7962,316,7522,87,175,2,6,0,270
7963,316,7523,59,182,4,1,0,246
7964,316,7524,80,189,3,1,3,276
7965,316,7525,70,197,2,6,0,275
7966,316,7526,49,217,3,4,0,273
7967,316,7527,72,195,0,5,0,272
7968,316,7528,58,188,4,10,0,260
7969,316,7529,79,189,5,7,0,280
7970,316,7530,71,194,3,4,0,272
7971,316,7531,73,191,4,4,0,272
7972,316,7532,68,201,5,3,0,277
7973,316,7533,96,183,1,3,0,283
7974,316,7534,71,209,1,1,0,282
7975,316,7535,53,194,5,2,0,254
7976,316,7536,57,196,3,2,1,259
7977,316,7537,60,211,0,9,0,280
7978,316,7538,59,191,1,8,1,260
7979,316,7539,65,200,1,5,0,271
7980,316,7540,56,212,3,10,1,282
7981,316,7541,80,180,2,2,0,264
7982,316,7542,70,209,1,3,0,283
7983,316,7543,68,202,1,5,2,278
7984,316,7544,62,194,2,7,0,265
7985,316,7545,71,207,2,5,0,285
7986,316,7546,83,188,0,7,0,278
7987,316,7547,56,222,5,8,0,291
7988,316,7548,64,203,4,6,0,277
7989,316,7549,73,198,1,3,0,275
7990,316,7550,65,199,8,8,0,280
7991,316,7551,57,211,4,2,0,274
7992,316,7552,83,174,5,8,0,270
7993,316,7553,59,199,3,8,0,269
7994,316,7554,55,218,1,5,0,279
7995,316,7555,58,193,6,9,0,266
7996,316,7556,78,201,3,5,0,287
7997,316,7557,82,189,3,5,1,280
7998,316,7558,89,181,3,3,0,276
7999,316,7559,73,179,2,13,0,267
8000,316,7560,72,203,1,3,0,279
8001,316,7561,58,213,3,5,0,279
8002,316,7562,63,200,4,6,0,273
8003,316,7563,66,199,2,5,0,272
8004,316,7564,77,184,1,5,0,267
8005,316,7565,57,210,6,5,0,278
8006,316,7566,66,196,1,1,0,264
8007,316,7567,69,198,4,6,0,277
8008,316,7568,60,202,4,9,0,275
8009,316,7569,73,176,2,4,0,255
8010,316,7570,53,201,3,10,0,267
8011,316,7571,49,213,8,0,0,270
8012,316,7572,63,210,1,3,0,277
8013,316,7573,83,185,3,6,0,277
8014,316,7574,72,193,2,8,0,275
8015,316,7575,80,183,1,8,0,272
8016,316,7576,69,192,3,5,0,269
8017,316,7577,66,189,4,15,0,274
8018,316,7578,78,202,2,8,0,290
8019,316,7579,62,210,1,1,0,274
8020,316,7580,49,220,2,7,2,280
8021,316,7581,86,186,2,8,0,282
8022,316,7582,68,195,4,8,0,275
8023,316,7583,54,223,1,2,0,280
8024,316,7584,78,187,1,8,0,274
8025,316,7585,58,218,0,3,0,279
8026,316,7586,61,201,2,8,0,272
8027,316,7587,65,205,1,4,0,275
8028,316,7588,64,201,5,3,0,273
8029,316,7589,56,223,1,4,0,284
8030,316,7590,60,202,4,8,0,274
8031,316,7591,74,198,1,4,0,277
8032,316,7592,63,199,3,5,0,270
8033,316,7593,61,203,0,8,0,272
8034,316,7594,67,205,0,3,0,275
8035,316,7595,38,221,4,5,0,268
8036,316,7596,75,180,6,10,0,271
8037,316,7597,0,0,0,0,0,0
8038,316F,7618,69,152,0,4,0,225
8039,316F,7619,44,172,1,8,0,225
8040,316F,7620,65,146,4,0,0,215
8041,328B,7720,62,133,4,4,0,203
8042,328B,7721,44,146,1,8,0,199
8043,328B,7722,41,152,1,4,0,198
8044,325,7670,40,177,0,3,0,220
8045,325,7671,45,187,4,0,0,236
8046,325,7672,71,165,2,0,0,238
8047,325,7673,55,165,4,3,0,227
8048,325,7674,67,159,5,0,0,231
8049,316I,7628,61,189,3,1,0,254
8050,316I,7629,57,161,4,5,0,227
8051,316I,7630,61,177,3,1,0,242
8052,316B,7610,38,95,0,1,0,134
8053,329,7723,32,105,2,4,0,143
8054,326A,7696,70,201,0,3,0,274
8055,326A,7697,50,212,2,4,0,268
8056,326A,7698,57,226,1,2,0,286
8057,326A,7699,64,204,2,8,0,278
8058,326A,7700,73,186,4,2,0,265
8059,326A,7701,59,201,1,5,0,266
8060,326A,7702,61,221,4,0,0,286
8061,326A,7703,50,211,1,3,0,265
8062,331,7728,52,214,10,0,0,276
8063,331,7729,80,188,0,0,0,268
8064,331,7730,60,207,4,0,0,271
8065,331,7731,54,217,1,0,0,272
8066,331,7732,84,181,0,3,0,268
8067,331,7733,67,211,2,1,0,281
8068,331,7734,54,203,4,4,0,265
8069,331,7735,76,199,3,3,0,281
8070,331,7736,64,199,1,7,0,271
8071,331,7737,60,205,6,3,0,274
8072,331,7738,57,200,1,5,0,263
8073,331,7739,57,217,3,0,0,277
8074,331,7740,64,181,7,0,0,252
8075,320,7647,0,3,0,0,0,3
8076,316C,7611,40,91,0,2,0,133
8077,367,8122,83,86,0,0,0,169
8078,367,8123,90,77,1,0,0,168
8079,361,8096,110,134,5,0,0,249
8080,361,8097,109,135,2,0,0,246
8081,361,8098,94,118,0,0,0,212
8082,361,8099,107,128,2,3,0,240
8083,361,8100,112,125,6,0,0,243
8084,361,8101,107,121,1,3,0,232
8085,369,8126,115,79,0,3,0,197
8086,369,8127,118,81,0,0,0,199
8087,365,8117,0,5,0,0,0,5
8088,360,8093,50,64,1,1,0,116
8089,360A,8094,70,96,1,1,0,168
8090,370A,8129,6,10,0,0,0,16
8091,371,8130,87,151,1,3,1,243
8092,371,8131,80,152,3,2,0,237
8093,371,8132,96,146,4,0,0,246
8094,371,8133,100,142,2,1,0,245
8095,371,8134,76,151,7,0,0,234
8096,371,8135,86,155,0,0,0,241
8097,368,8124,155,103,2,2,0,262
8098,368,8125,149,125,1,2,0,277
8099,362,8102,2,13,0,0,0,15
8100,366,8118,142,54,1,0,0,197
8101,366,8119,142,49,5,1,0,197
8102,366,8120,119,78,0,1,0,198
8103,366,8121,126,77,1,1,0,205
8104,370,8128,19,28,2,1,0,50
8105,360B,8095,32,41,0,0,0,73
8106,363,8103,9,7,0,0,0,16
8107,364,8104,91,151,4,12,0,258
8108,364,8105,91,177,1,3,0,272
8109,364,8106,87,173,3,0,0,263
8110,364,8107,87,185,3,4,0,279
8111,364,8108,94,158,0,1,0,253
8112,364,8109,72,195,6,4,0,277
8113,364,8110,106,145,1,2,0,254
8114,364,8111,99,164,0,2,0,265
8115,364,8112,102,168,1,1,0,272
8116,364,8113,88,185,2,4,0,279
8117,364,8114,81,179,2,2,0,264
8118,364,8115,62,200,1,5,0,268
8119,364,8116,99,158,2,6,0,265
8120,261A,6724,112,151,5,0,0,268
8121,261A,6725,100,155,2,1,0,258
8122,261A,6726,106,153,2,0,0,261
8123,261B,6727,8,18,0,0,0,26
8124,263B,6760,1,11,0,0,0,12
8125,263A,6759,27,42,1,3,0,73
8126,263E,6765,76,99,2,2,0,179
8127,263E,6766,58,113,0,6,0,177
8128,263E,6767,68,111,0,7,0,186
8129,260,6703,80,134,1,4,0,219
8130,260,6704,80,145,1,4,0,230
8131,260,6705,85,150,2,6,0,243
8132,266A,6806,67,24,1,0,0,92
8133,263D,6763,66,107,7,5,0,185
8134,263D,6764,90,93,10,3,0,196
8135,265C,6798,148,54,1,1,0,204
8136,265C,6799,142,72,0,2,0,216
8137,265C,6800,147,69,1,4,0,221
8138,259,6702,4,7,0,0,0,11
8139,263C,6761,109,167,2,3,0,281
8140,263C,6762,93,147,2,2,0,244
8141,265A,6784,152,128,2,1,0,283
8142,265A,6785,146,134,0,3,0,283
8143,265A,6786,127,150,2,4,0,283
8144,265A,6787,119,154,0,3,0,276
8145,265A,6788,119,151,1,6,0,277
8146,265A,6789,123,148,0,0,0,271
8147,265A,6790,124,164,2,1,0,291
8148,265A,6791,152,133,3,0,0,288
8149,265A,6792,131,168,3,0,0,302
8150,265A,6793,121,143,5,0,0,269
8151,265A,6794,132,142,0,1,0,275
8152,265A,6795,140,149,1,0,0,290
8153,265A,6796,124,150,4,0,0,278
8154,260A,6706,4,14,0,0,0,18
8155,262,6728,98,191,3,5,0,297
8156,262,6729,78,194,4,9,0,285
8157,262,6730,64,212,4,9,0,289
8158,262,6731,74,199,0,11,0,284
8159,262,6732,83,191,4,4,0,282
8160,262,6733,88,184,1,5,0,278
8161,262,6734,78,187,2,5,0,272
8162,262,6735,79,193,1,5,0,278
8163,262,6736,77,211,1,7,0,296
8164,262,6737,88,189,2,3,0,282
8165,262,6738,65,221,1,12,0,299
8166,262,6739,75,188,13,3,0,279
8167,262,6740,62,216,1,3,0,282
8168,262,6741,78,203,2,3,0,286
8169,262,6742,72,185,2,9,0,268
8170,262,6743,54,216,3,3,0,276
8171,262,6744,60,197,3,5,0,265
8172,262,6745,69,200,0,8,0,277
8173,262,6746,86,190,5,3,0,284
8174,262,6747,75,201,0,5,0,281
8175,262,6748,76,185,10,0,0,271
8176,262,6749,73,197,4,9,0,283
8177,262,6750,60,209,1,6,0,276
8178,262,6751,83,186,2,5,0,276
8179,263,6752,97,184,8,5,0,294
8180,263,6753,90,184,1,3,0,278
8181,263,6754,68,178,2,4,0,252
8182,263,6755,78,167,5,10,0,260
8183,263,6756,71,178,5,5,0,259
8184,263,6757,56,207,3,12,0,278
8185,263,6758,87,168,5,6,0,266
8186,261,6707,88,172,0,2,0,262
8187,261,6708,79,189,1,1,0,270
8188,261,6709,84,187,6,2,0,279
8189,261,6710,57,209,0,6,0,272
8190,261,6711,66,203,1,6,0,276
8191,261,6712,61,206,1,8,0,276
8192,261,6713,83,199,3,4,0,289
8193,261,6714,79,190,7,0,0,276
8194,261,6715,74,190,2,0,0,266
8195,261,6716,87,177,4,4,0,272
8196,261,6717,72,193,2,7,0,274
8197,261,6718,56,205,4,5,0,270
8198,261,6719,80,184,1,4,0,269
8199,261,6720,81,185,0,7,0,273
8200,261,6721,96,177,2,3,0,278
8201,261,6722,72,177,4,11,0,264
8202,261,6723,93,164,0,3,0,260
8203,264,6768,65,90,3,6,0,164
8204,264,6769,83,58,1,0,0,142
8205,266,6801,106,67,1,1,0,175
8206,266,6802,114,68,2,3,0,187
8207,266,6803,141,54,2,3,0,200
8208,266,6804,122,58,1,1,0,182
8209,266,6805,117,82,0,1,0,200
8210,264A,6770,58,82,2,2,0,144
8211,265B,6797,22,14,1,0,0,37
8212,265,6771,124,129,4,0,0,257
8213,265,6772,142,106,2,0,0,250
8214,265,6773,106,140,9,0,0,255
8215,265,6774,122,120,1,1,0,244
8216,265,6775,0,0,0,0,0,0
8217,265,6776,125,114,3,0,0,242
8218,265,6777,128,126,5,0,0,259
8219,265,6778,125,125,3,3,0,256
8220,265,6779,131,116,1,3,0,251
8221,265,6780,119,117,4,0,0,240
8222,265,6781,128,132,0,0,0,260
8223,265,6782,127,128,3,0,0,258
8224,265,6783,117,126,1,2,0,246
8225,253,6683,69,161,4,0,0,234
8226,253,6684,99,144,6,0,0,249
8227,253,6685,80,147,0,7,0,234
8228,253,6686,66,145,6,8,0,225
8229,257,6691,75,200,2,4,0,281
8230,257,6692,69,205,6,0,0,280
8231,257,6693,71,196,4,3,0,274
8232,257,6694,56,210,11,0,0,277
8233,257,6695,70,202,3,3,0,278
8234,257,6696,54,205,1,4,0,264
8235,257,6697,67,204,9,0,0,280
8236,257,6698,86,199,2,4,0,291
8237,257,6699,81,197,8,0,0,286
8238,255,6688,63,132,2,1,0,198
8239,255,6689,68,134,1,0,0,203
8240,256,6690,39,78,1,3,0,121
8241,258,6700,81,147,4,4,0,236
8242,258,6701,86,144,2,3,0,235
8243,251,6667,34,38,1,1,0,74
8244,254,6687,38,41,0,1,0,80
8245,248,6609,96,166,12,0,0,274
8246,248,6610,81,179,5,0,0,265
8247,248,6611,86,156,4,3,0,249
8248,248,6612,89,159,4,8,0,260
8249,248,6613,68,189,4,0,0,261
8250,248,6614,81,172,2,4,0,259
8251,248,6615,89,177,3,3,0,272
8252,248,6616,59,209,2,1,0,271
8253,248,6617,46,219,2,1,1,269
8254,248,6618,99,169,3,0,0,271
8255,248,6619,78,193,0,3,0,274
8256,248,6620,82,176,3,4,0,265
8257,248,6621,50,205,2,2,0,259
8258,248,6622,75,185,3,4,0,267
8259,248,6623,79,184,6,0,0,269
8260,248,6624,67,193,3,2,0,265
8261,248,6625,63,185,2,7,0,257
8262,248,6626,82,170,0,5,0,257
8263,248,6627,84,169,3,10,0,266
8264,248,6628,79,190,0,2,0,271
8265,248,6629,58,202,2,0,0,262
8266,248,6630,66,202,6,0,0,274
8267,248,6631,63,205,3,3,0,274
8268,248,6632,65,188,5,1,0,259
8269,248,6633,72,179,2,3,0,256
8270,248,6634,70,198,1,3,0,272
8271,248,6635,64,213,1,2,0,280
8272,248,6636,60,199,2,1,0,262
8273,248,6637,74,192,3,0,0,269
8274,248,6638,77,177,3,3,0,260
8275,248,6639,59,198,4,3,0,264
8276,248,6640,75,180,2,3,0,260
8277,248,6641,71,187,2,5,0,265
8278,248,6642,68,197,2,2,0,269
8279,248,6643,88,164,6,0,0,258
8280,248,6644,80,157,3,6,0,246
8281,248,6645,76,173,5,4,0,258
8282,248,6646,82,165,1,4,0,252
8283,248,6647,65,192,1,4,0,262
8284,248,6648,83,155,1,4,0,243
8285,248,6649,55,193,1,2,0,251
8286,248,6650,76,171,2,3,0,252
8287,248,6651,58,186,3,0,0,247
8288,248,6652,96,148,2,3,0,249
8289,248,6653,82,182,2,2,0,268
8290,248,6654,59,191,2,4,0,256
8291,248,6655,56,203,2,4,0,265
8292,248,6656,76,175,2,1,0,254
8293,248,6657,77,186,1,2,0,266
8294,248,6658,72,182,5,5,0,264
8295,248,6659,65,198,1,2,0,266
8296,248,6660,60,180,4,0,0,244
8297,248,6661,56,189,4,3,0,252
8298,249,6662,62,143,3,0,0,208
8299,249,6663,58,144,5,2,0,209
8300,249,6664,53,134,5,0,0,192
8301,249,6665,87,107,3,0,0,197
8302,249,6666,61,157,1,2,0,221
8303,252,6668,81,180,4,7,0,272
8304,252,6669,62,188,1,5,0,256
8305,252,6670,59,209,1,4,0,273
8306,252,6671,78,195,1,4,0,278
8307,252,6672,65,218,1,5,0,289
8308,252,6673,67,186,1,2,0,256
8309,252,6674,50,218,2,4,0,274
8310,252,6675,72,196,0,5,0,273
8311,252,6676,83,182,0,2,0,267
8312,252,6677,79,187,3,7,0,276
8313,252,6678,79,180,4,11,0,274
8314,252,6679,46,226,1,7,0,280
8315,252,6680,83,192,2,2,0,279
8316,252,6681,85,162,1,6,0,254
8317,252,6682,92,180,2,7,0,281
8318,70,4165,98,147,5,0,0,250
8319,70,4166,87,156,3,1,0,247
8320,70,4167,91,147,0,3,0,241
8321,70,4168,103,134,1,1,0,239
8322,70,4169,57,192,0,5,0,254
8323,70,4170,93,151,6,0,0,250
8324,70,4171,99,129,3,0,0,231
8325,70,4172,105,132,4,0,0,241
8326,70,4173,84,147,4,0,0,235
8327,70,4174,69,175,3,3,0,250
8328,70,4175,110,128,2,0,0,240
8329,70,4176,111,149,0,4,0,264
8330,70,4177,100,152,1,4,0,257
8331,70,4178,113,126,7,0,0,246
8332,70,4179,93,157,6,0,0,256
8333,60,4106,72,165,2,7,0,246
8334,60,4107,57,187,2,0,0,246
8335,60,4108,54,203,3,0,0,260
8336,60,4109,86,142,5,0,0,233
8337,60,4110,56,186,1,1,0,244
8338,60,4111,93,164,0,1,0,258
8339,60,4112,70,178,0,1,0,249
8340,60,4113,67,178,2,3,0,250
8341,60,4114,105,143,0,2,0,250
8342,60,4115,47,201,6,1,0,255
8343,63,4143,54,219,3,0,0,276
8344,63,4144,58,208,1,0,0,267
8345,63,4145,32,247,0,1,0,280
8346,63,4146,35,233,2,2,0,272
8347,63,4147,70,185,0,3,0,258
8348,63,4148,63,200,1,2,0,266
8349,63,4149,67,197,1,1,0,266
8350,63,4150,42,215,1,0,0,258
8351,63,4151,49,207,1,1,0,258
8352,63,4152,61,197,2,1,0,261
8353,63,4153,63,197,2,0,0,262
8354,63,4154,46,219,2,4,0,271
8355,63,4155,45,185,2,3,0,235
8356,71,4180,105,120,2,1,0,228
8357,62,4139,79,135,2,0,0,216
8358,62,4140,73,150,5,0,0,228
8359,62,4141,79,125,3,0,0,207
8360,62,4142,79,126,4,5,0,214
8361,65,4156,0,13,0,0,0,13
8362,66,4157,45,204,5,0,0,254
8363,66,4158,52,206,2,0,0,260
8364,66,4159,54,208,6,0,0,268
8365,66,4160,59,202,5,0,0,266
8366,66,4161,72,192,6,0,0,270
8367,72,4181,104,168,2,1,0,275
8368,72,4182,101,145,3,1,0,250
8369,72,4183,96,148,2,6,0,252
8370,72,4184,88,192,0,1,0,281
8371,72,4185,68,195,1,3,0,267
8372,72,4186,13,185,1,2,1,202
8373,72,4187,92,166,2,3,0,263
8374,72,4188,75,185,0,6,0,266
8375,61,4116,101,123,2,2,0,228
8376,61,4117,92,144,3,7,0,246
8377,61,4118,78,150,7,3,0,238
8378,61,4119,76,178,5,8,0,267
8379,61,4120,91,157,0,4,0,252
8380,61,4121,117,118,3,2,0,240
8381,61,4122,88,141,1,3,0,233
8382,61,4123,106,149,0,3,0,258
8383,61,4124,97,145,1,6,0,249
8384,61,4125,99,132,1,4,0,236
8385,61,4126,85,164,0,2,0,251
8386,61,4127,94,153,5,0,0,252
8387,61,4128,115,119,2,4,0,240
8388,61,4129,100,151,0,2,0,253
8389,61,4130,79,160,0,4,0,243
8390,61,4131,85,141,5,0,0,231
8391,61,4132,88,161,0,5,0,254
8392,61,4133,116,115,2,4,0,237
8393,61,4134,121,123,5,0,0,249
8394,61,4135,99,128,1,1,0,229
8395,61,4136,84,156,1,4,0,245
8396,61,4137,83,154,3,0,0,240
8397,61,4138,97,142,2,2,0,243
8398,69,4164,8,32,0,0,0,40
8399,58,4099,99,107,1,0,0,207
8400,59,4100,54,182,1,1,0,238
8401,59,4101,75,159,2,2,0,238
8402,59,4102,50,154,2,7,0,213
8403,59,4103,51,166,0,4,0,221
8404,59,4104,54,159,5,0,0,218
8405,59,4105,64,162,5,0,0,231
8406,68,4163,65,142,1,3,0,211
8407,67,4162,15,31,0,0,0,46
