escuela,direccion,seccion_nro,seccion_nombre,circuito_nro,circuito_nombre,mesas,desde,hasta,electores
CENTRO EDUC.NIVEL MEDIO ADULTO,DEAN FUNES 417,1,CAPITAL,1,SECCIONAL PRIMERA,7,1,7,2408
ESC NUESTRA SEÑORA DEL HUERTO,BELGRANO 269,1,CAPITAL,1,SECCIONAL PRIMERA,12,8,19,4119
COL NAC DE MONSERRAT,OBISPO TREJO 294,1,CAPITAL,1,SECCIONAL PRIMERA,17,20,36,5831
ESC SANTA TERESA DE JESUS,OBISPO TREJO Y SANABRIA 160,1,CAPITAL,1,SECCIONAL PRIMERA,10,37,46,3430
ESC JUAN BAUTISTA ALBERDI,GRAL PAZ 486,1,CAPITAL,2,SECCIONAL SEGUNDA,17,47,63,5693
ESC JERONIMO LUIS DE CABRERA,SANTA ROSA 650,1,CAPITAL,3,SECCIONAL TERCERA,14,64,77,4830
IPEM N° 270 GRAL M BELGRANO,DEAN FUNES 850,1,CAPITAL,3,SECCIONAL TERCERA,10,78,87,3450
ESC SANTO TOMAS,CASEROS 745,1,CAPITAL,3,SECCIONAL TERCERA,8,88,95,2756
ESC NORMAL ALEJANDRO CARBO,AV COLON 951,1,CAPITAL,3,SECCIONAL TERCERA,13,96,108,4472
ESC MARIANO MORENO,SANTA ROSA ESQ SANTA FE,1,CAPITAL,3,SECCIONAL TERCERA,13,109,121,4472
ENET N° 3 LEOPOLDO LUGONES,ITUZAINGO 483,1,CAPITAL,4,NUEVA CORDOBA,12,122,133,4128
COL NACIONAL DEAN FUNES,PERU 10,1,CAPITAL,4,NUEVA CORDOBA,20,134,153,6880
ESC GDOR ALVAREZ,C ARENAL 699 B°R MARTINEZ,1,CAPITAL,4,NUEVA CORDOBA,11,154,164,3784
FAC DE CIENCIAS ECONOMICAS,AV VALPARAISO CDAD UNIVERSITARIA,1,CAPITAL,4,NUEVA CORDOBA,16,165,180,5495
ESC ERNESTO BANCALARI,MONTERROSO 4597 B° ARTIGAS,1,CAPITAL,4A,PUEBLO LAS FLORES,7,181,187,2373
ESC ALMAFUERTE,CHANETON 390 B° SAN FERNANDO,1,CAPITAL,4A,PUEBLO LAS FLORES,7,188,194,2373
ESC COM R ECHEGOYEN,J I DIAZ 200 B° EJERCITO ARGENTINO,1,CAPITAL,4A,PUEBLO LAS FLORES,8,195,202,2708
ESC SAN FRANCISCO DE ASIS,GUARDADO 184 B°LAS FLORES,1,CAPITAL,4A,PUEBLO LAS FLORES,29,203,231,9802
INST EDUC NTRA SEÑORA,INCA MANCO 3450,1,CAPITAL,4B,VILLA REVOL,22,232,253,7464
ESC ING MASJOAN,P.L.DE CABRERA ESQ.TANTI B°V. REVOL,1,CAPITAL,4B,VILLA REVOL,10,254,263,3390
COL NICOLAS BERROTARAN,ELIAS YOFRE 1095,1,CAPITAL,4B,VILLA REVOL,14,264,277,4746
ESC L SUAREZ DE FIGUEROA,DEFENSA S/N° LA HUERTILLA,1,CAPITAL,4C,INAUDI,6,278,283,1986
ESC SAN JOSE DE CALASANZ,PIZARRO ESQ. NIVOLI,1,CAPITAL,4C,INAUDI,7,284,290,2314
COL VILLA EUCARISTICA,CNO A SAN CARLOS KM.5 1/2,1,CAPITAL,4D,VILLA EUCARISTICA,6,291,296,1942
ESC.SABIN,DDE.CMO.S.ANTONIO KM 7 1/2.1KM.AL O.,1,CAPITAL,4E,NUESTRO HOGAR III,7,297,303,2135
NSC.OSCAR RAUL MALVASIO,MANZANA 49 B° C.OBISPO ANGELELLI,1,CAPITAL,4F,CIUDAD OBISPO ANGELELLI,7,304,310,2325
ESC ESPAÑA,M BRAVO Y ENTRE RIOS,1,CAPITAL,5,ALTAMIRA,16,311,326,5472
ESC GRECIA,PEDERNERA 952 B°SAN VICENTE,1,CAPITAL,5,ALTAMIRA,10,327,336,3420
ESC PANAMERICANA,SOTO 919,1,CAPITAL,5,ALTAMIRA,9,337,345,3078
ESC ESTANISLAO DEL CAMPO,ESTADOS UNIDOS Y RIO 1° B°ALTAMIRA,1,CAPITAL,5,ALTAMIRA,5,346,350,1706
ESC MUNICIPAL A GASTALDI,S JERONIMO 5500/ALMAGRO COL LOLA,1,CAPITAL,5A,COLONIA LOLA,6,351,356,1944
ELENA LOPEZ LALLANA,AGUSTIN GARZON 5.600,1,CAPITAL,5A,COLONIA LOLA,10,357,366,3234
ESC 9 DE JULIO,JOSE A CABRERA 4717 B°DEAN FUNES,1,CAPITAL,5B,DEAN FUNES,6,367,372,1892
ESC PROVINCIA DE LA RIOJA,JUNIN 3480 B°EMPALME,1,CAPITAL,5C,EMPALME,12,373,384,4080
ESC VICTOR MERCANTE,CAUCETE 4008 B°EMPALME,1,CAPITAL,5C,EMPALME,11,385,395,3740
ESC JUAN M DE PUEYRREDON,ANCASTI 4555 B°EMPALME,1,CAPITAL,5C,EMPALME,7,396,402,2380
INST SEC EMPALME GONZALEZ LACA,LAS ARRIAS 4043 B°EMPALME,1,CAPITAL,5C,EMPALME,5,403,407,1700
FRAY JUSTO STA MARÍA DE ORO,CALLAO 2.320,1,CAPITAL,5C,EMPALME,12,408,419,4075
ELENA LOPEZ LALLANA,AGUSTÍN GARZON 5.636,1,CAPITAL,5C,EMPALME,5,420,424,1695
ESC CANONIGO PIÑERO,CAMPO LA RIBERA,1,CAPITAL,5D,MALDONADO,6,425,430,2010
ESC MARTIN DE GÜEMES,OBPO CASTELLANOS 256 B°MÜLLER,1,CAPITAL,5D,MALDONADO,9,431,439,3015
BAC TEC DR F ESCARDO,CAMPO LA RIBERA,1,CAPITAL,5D,MALDONADO,9,440,448,3006
IPEM 184-M.FRAGUEIRO,OB.CASTELLANO 955.S.VICENTE,1,CAPITAL,5D,MALDONADO,8,449,456,2672
ESC TTE GRAL P RICCHIERI,BENJAMIN VIEL 2387,1,CAPITAL,5E,VILLA BUSTOS,12,457,468,4055
ESC M COOPERATIVISMO ARGENTINO,M BRAVO Y PJE.MATHEUB° RENACIMIENTO,1,CAPITAL,5F,RENACIMIENTO,13,469,481,4482
ESC SANTA MARGARITA DE CORTONA,LOPEZ Y PLANES 2936 B°SAN VICENTE,1,CAPITAL,5G,SAN VICENTE,10,482,491,3450
ESC DGO F SARMIENTO,LOPEZ Y PLANES 2253 B°SAN VICENTE,1,CAPITAL,5G,SAN VICENTE,14,492,505,4830
ESC PTE RIVADAVIA,AGUSTIN GARZON 1563 B°SAN VICENTE,1,CAPITAL,5G,SAN VICENTE,12,506,517,4139
ESC MARIA IGNACIA NAVARRO DE L,CORRIENTES 2006 B°SAN VICENTE,1,CAPITAL,5G,SAN VICENTE,10,518,527,3440
ESC. MADRE MARIA DEL TRANSITO,MANZANA 7. B° VILLA BOEDO,1,CAPITAL,5H,VILLA BOEDO,6,528,533,1742
ESCUELA HEROES DE MALVINAS,CALLE PUBLICA S/N (CNO VILLA POSSE),1,CAPITAL,5I,COLINAS DEL SUR,8,534,541,2720
ESC.PTE. JUAN D.PERÓN,MANZANA 47.B° CIUDAD EVITA,1,CAPITAL,5I,COLINAS DEL SUR,6,542,547,2036
ESC TENIENTE GRAL ARAMBURU,GARIBALDI 710 B°ALTO GRAL PAZ,1,CAPITAL,6,ALTO GRAL PAZ,9,548,556,2988
COL   SAN RAMON NONATO,AVDA   PATRIA 282 B°ALTO GRAL PAZ,1,CAPITAL,6,ALTO GRAL PAZ,7,557,563,2317
ESC MUNICIPAL DR   A SOBRAL,PUBLICA S/N° B°SANGRE Y SOL,1,CAPITAL,6A,BAJADA DE PIEDRA,1,564,564,340
ESC VAN GELDEREN,CNO CHACRA DE LA MERCED KM 6 1/2,1,CAPITAL,6B,CHACRA DE LA MERCED,1,565,565,244
ESC RAMON J CARCANO,VIAMONTE 446 B°GRAL.PAZ,1,CAPITAL,6C,GRAL PAZ,11,566,576,3707
ESC NORMAL GARZON AGULLA,VIAMONTE 150 B°GRAL PAZ,1,CAPITAL,6C,GRAL PAZ,14,577,590,4718
IPET N°10 COM MARTIN RIVADAVIA,25 DE MAYO Y ROMA B°GRAL PAZ,1,CAPITAL,6C,GRAL PAZ,10,591,600,3367
ESC GABRIELA MISTRAL,LEONOR DE TEJEDA B°JUNIORS 1.353,1,CAPITAL,6D,JUNIORS,10,601,610,3358
ESC BRIGADIER C SAAVEDRA,ARENALES Y LA PLATA B°JUNIORS,1,CAPITAL,6D,JUNIORS,11,611,621,3685
ESC TRANSITO CACERES DE ALLEND,CNO CHACRA DE LA MERCED KM 9 Y 1/2,1,CAPITAL,6E,LA FLORESTA SUD,7,622,628,2121
ESC R GÜIRALDES,24 DE SETIEMBRE 2400 B°YAPEYU,1,CAPITAL,6F,YAPEYU,12,629,640,4128
ESC GDOR AMADEO SABATTINI,GERMANIA 2500 B°YAPEYU,1,CAPITAL,6F,YAPEYU,11,641,651,3774
ESC JORGE NEWBERY (CIRC 7F),MATIENZO 5.895,1,CAPITAL,7,AEROPUERTO,1,652,652,150
IPEM N° 22 JUAN FILLOY,CALLE DE LA CUECA,1,CAPITAL,7A,GUIÑAZU,6,653,658,1992
ESC UNESCO,JUAN B JUSTO/AV N SRA D LOS MILAGROS,1,CAPITAL,7A,GUIÑAZU,14,659,672,4646
ESC MANUEL LUCERO,MANUEL LUCERO 560 B°ALTA CORDOBA,1,CAPITAL,7B,ALTA CORDOBA,19,673,691,6527
ESC PCIA DE ENTRE RIOS,TRAFALGAR 875 B°ALTA CORDOBA,1,CAPITAL,7B,ALTA CORDOBA,11,692,702,3773
INST CORAZON DE MARIA,A DEL VISO 445 B°ALTA CORDOBA,1,CAPITAL,7B,ALTA CORDOBA,14,703,716,4802
INST NUESTRA MADRE DE LA MERCE,M FRAGUEIRO B°ALTA CORDOBA 2.400,1,CAPITAL,7B,ALTA CORDOBA,13,717,729,4459
INST MANUEL LUCERO,LAVALLEJA 2257 B°ALTA CORDOBA,1,CAPITAL,7B,ALTA CORDOBA,9,730,738,3087
ESC J NEWBERY,MATIENZO 5895 B°J NEWBERY,1,CAPITAL,7C,CNO. A PAJAS BLANCAS,1,739,739,11
ESC PTE SARMIENTO,R SAENZ PEÑA 1212 B°COFICO,1,CAPITAL,7D,COFICO,11,740,750,3729
ESC PCIA DE FORMOSA,RODRIGUEZ PEÑA 1548 B°COFICO,1,CAPITAL,7D,COFICO,7,751,757,2370
ESC. GARCIA FAURE,JERONIMO LUIS DE CABRERA 834,1,CAPITAL,7D,COFICO,9,758,766,3042
ESC HONORATO LACONI,T DE IROBI B°M DE SOBREMONTE,1,CAPITAL,7E,MARQUES DE SOBREMONTE,14,767,780,4816
ESC PETER PAN,P DE GUZMAN 131 B°M DE SOBREMONTE,1,CAPITAL,7E,MARQUES DE SOBREMONTE,14,781,794,4816
J DE INF B.RIVADAVIA,NUFLO DE AGUILAR 541,1,CAPITAL,7E,MARQUES DE SOBREMONTE,3,795,797,1032
JOSE LUIS SERCIC,PEREZ CORREA 1500 M DE SOBREMONTE,1,CAPITAL,7E,MARQUES DE SOBREMONTE,8,798,805,2746
IPEM 338,FRANCISCO SUAREZ 3.760,1,CAPITAL,7E,MARQUES DE SOBREMONTE,8,806,813,2744
ESC JORGE NEWBERY,BENJAMIN MATIENZO Bº NEWBERY 5.895,1,CAPITAL,7F,JORGE NEWBERY,10,814,823,3440
ESC NACIONES UNIDAS,CTDA   8 S/N°B°R DE ESCALADA,1,CAPITAL,7F,JORGE NEWBERY,9,824,832,3092
IPEM 121 PAEZ MOLINA,ORIGONE ESQ CAROLA LORENZINI,1,CAPITAL,7F,JORGE NEWBERY,5,833,837,1715
ESC GOBERNADOR MANUEL LOPEZ,URQUIZA 4.800,1,CAPITAL,7G,PANAMERICANO,7,838,844,2394
ESC ARTURO CAPDEVILA,AVELLANEDA 4100 B°MFRAGUEIRO,1,CAPITAL,7G,PANAMERICANO,12,845,856,4104
ESC FRANCISCO VIDAL,"FRAGUEIRO   (MANZANA ""C"") 4.200",1,CAPITAL,7G,PANAMERICANO,12,857,868,4097
"IPEM 199 ""JUAN EMILIO REMONDA""",SOSA REVELLO Y 15 DE SEPTIEMBRE 590,1,CAPITAL,7G,PANAMERICANO,5,869,873,1705
ESC RABINDRANAT TAGORE,OCARINA 1613,1,CAPITAL,8,LA FLORESTA NORTE,3,874,876,702
ESC EMILIO E SANCHEZ,ANTONIO MACHONI 1.700,1,CAPITAL,8A,PALMAR,12,877,888,3931
ESC FRAY J A DE SAN ALBERTO,ESQUIU 1340 B°PUEYRREDON,1,CAPITAL,8B,PUEYRREDON,7,889,895,2408
INST OBISPO CAIXAL,ANA M JANER 1250 B°PUEYRREDON,1,CAPITAL,8B,PUEYRREDON,8,896,903,2752
ESC DEAN FUNES,ANA M JANER 1551 B°PUEYRREDON,1,CAPITAL,8B,PUEYRREDON,10,904,913,3439
INST SAGRADO CORAZON,ROMA 1153 B°PUEYRREDON,1,CAPITAL,8B,PUEYRREDON,10,914,923,3430
ESC ROBLES,PADRE LUIS MONTI 1850 B°PUEYRREDON,1,CAPITAL,8B,PUEYRREDON,12,924,935,4116
INST SAGRADA FAMILIA,BUCHARDO 1729 B° PUEYRREDON,1,CAPITAL,8B,PUEYRREDON,10,936,945,3430
ESC TRINIDAD MORENO,E SAN MARTIN 1251 B°YOFRE SUD,1,CAPITAL,8C,VILLA LOS PINOS,12,946,957,4044
ESC ALMIRANTE BROWN,SAN MARTIN S/N° B° YOFRE SUD,1,CAPITAL,8C,VILLA LOS PINOS,13,958,970,4373
ESC PROVINCIA DE CORRIENTES,DOMINGO ZIPOLI 1358 B°ESCOBAR,1,CAPITAL,9,ESCOBAR,8,971,978,2613
INST ESCUTI,NAZARET 3399,1,CAPITAL,9,ESCOBAR,10,979,988,3260
ESC MAHATMA GANDHI,TALAVERA DE MADRID 3261 B°LA FRANCE,1,CAPITAL,9A,LA FRANCE,7,989,995,2310
COL PQUIAL C NAMUNCURA,DIAGUITAS 3.314,1,CAPITAL,9A,LA FRANCE,8,996,1003,2632
ESC RICARDO ROJAS,J.LOPEZ 2050 B°ALTOS DE V CABRERA,1,CAPITAL,9B,LAS MARGARITAS,8,1004,1011,2656
ESC CONGRESO DE TUCUMAN,MALVINO 2772 B°LAS MARGARITAS,1,CAPITAL,9B,LAS MARGARITAS,6,1012,1017,1992
ESC MIGUEL RODRIGUEZ DE LA TOR,LA GRANJA 3199 B°ALTO VERDE,1,CAPITAL,9B,LAS MARGARITAS,10,1018,1027,3320
ESC DE COMERCIO J J PASO,PLATON 3030 B°LOS PARAISOS,1,CAPITAL,9C,LOS PARAISOS,10,1028,1037,3402
COLEGIO FERMIN LAFITTE,FCO VALLE 2443 B°LOS PARAISOS,1,CAPITAL,9C,LOS PARAISOS,10,1038,1047,3400
ESC JUVENILIA,ZARATE 2083,1,CAPITAL,9C,LOS PARAISOS,7,1048,1054,2380
ESC PCIA DE MISIONES,FIRPO 2254 B° ZUMARAN,1,CAPITAL,9C,LOS PARAISOS,14,1055,1068,4760
COL EL SALVADOR,RAUL CASARIEGO 4479 B°P LUGONES,1,CAPITAL,9D,POETA LUGONES,8,1069,1076,2697
ESC LEOPOLDO LUGONES,LESPADA Y GALVEZ B°POETA LUGONES,1,CAPITAL,9D,POETA LUGONES,10,1077,1086,3370
IPEM 198 MARTIN FERREYRA,CAMAÑO BAZAN E/CARLES Y A.GRIMAU,1,CAPITAL,9D,POETA LUGONES,9,1087,1095,3033
ESC PTE HIPOLITO YRIGOYEN,CASTRO BARROS 802 B°SAN MARTIN,1,CAPITAL,9E,PROVIDENCIA,15,1096,1110,4903
ESC ANTONIO DEL VISO,SAAVEDRA 619 B°SAN MARTIN,1,CAPITAL,9F,SAN MARTIN,13,1111,1123,4407
INST INMACULADA CONCEPCION,CASTRO BARROS 1316 B°SAN MARTIN,1,CAPITAL,9F,SAN MARTIN,17,1124,1140,5749
ESC J DE SAN MARTIN,CERRITO Y GALAN B°SAN MARTIN,1,CAPITAL,9F,SAN MARTIN,7,1141,1147,2366
COL NTRA SEÑORA DE LA MERCED,ZELAYA 140 B°SAN MARTIN,1,CAPITAL,9F,SAN MARTIN,8,1148,1155,2704
INSTITUTO PEÑA,CIUDAD DE TAMPA 2954 VILLA CABRERA,1,CAPITAL,9G,VILLA CABRERA,10,1156,1165,3280
ESC PRESIDENTE KENNEDY,JULIAN PAZ 1851 VILLA CABRERA,1,CAPITAL,9G,VILLA CABRERA,8,1166,1173,2619
ESC ROQUE SAENZ PEÑA,AV VELEZ SARSFIELD 1000 B°GÜEMES,1,CAPITAL,10,BELLA VISTA,14,1174,1187,4774
INST EDUCACION CORDOBA,FERREYRA Y FRIULI B°COL DE V SARSF,1,CAPITAL,10,BELLA VISTA,18,1188,1205,6138
E.N.E.T. N°1 DR A SABATTINI,AV VELEZ SARSFIELD 1490 B°GÜEMES,1,CAPITAL,10,BELLA VISTA,10,1206,1215,3408
ESC MANUEL BELGRANO,SUECIA 2832 B° PQUE VELEZ SARSFIELD,1,CAPITAL,10,BELLA VISTA,9,1216,1224,3060
ESC MUN YAMAHIBIA ARABE LIBIA,COLORADO/GAIMAN/MASCACHIN B°CABILDO,1,CAPITAL,10A,CABILDO,9,1225,1233,3071
IPEM 311,USUAHIA 2.150,1,CAPITAL,10A,CABILDO,5,1234,1238,1705
ESC PCIA DE CATAMARCA,AV VELEZ SARSFIELD 3200 LAS FLORES,1,CAPITAL,10B,CIUDADELA,17,1239,1255,5780
ESC REPUBLICA DE SIRIA,TRAFUL 908 B°PQUE ATLANTICA,1,CAPITAL,10B,CIUDADELA,6,1256,1261,2040
ESC GDOR J B BUSTOS,CACHEUTA Y BRANDAN-ALTO V.SARSFIELD,1,CAPITAL,10B,CIUDADELA,11,1262,1272,3729
J DE INF REPUBLICA DE SIRIA,VIRGILIO MOYANO 830,1,CAPITAL,10B,CIUDADELA,2,1273,1274,678
ESC ALEJANDRO CARBO,ICHO CRUZ S/N° B° COMERCIAL,1,CAPITAL,10C,COMERCIAL,15,1275,1289,5161
ESC MUNIC AZOR GRIMAUT,SOBREMONTE Y RIO III B°COMERCIAL,1,CAPITAL,10C,COMERCIAL,5,1290,1294,1720
ESC MUNIC REPUBLICA DE ITALIA,REALICO Y CURAZAO B° CONGRESO,1,CAPITAL,10D,CONGRESO,6,1295,1300,1974
"IPEM 183""PEDRO B.PALACIOS""",REALICO B° CONGRESO 2.407,1,CAPITAL,10D,CONGRESO,4,1301,1304,1316
ESC CADETES FUERZA AEREA,LEOPOLDO CASAVEGA 2.320,1,CAPITAL,10E,ESTACION FLORES,11,1305,1315,3707
ESC PADRE BURON,AVIADOR MIRA,1,CAPITAL,10E,ESTACION FLORES,8,1316,1323,2696
J DE INF CADETES FUERZA AEREA,LEOPOLDO CASAVEGA 2.320,1,CAPITAL,10E,ESTACION FLORES,1,1324,1324,337
ESC ALAS ARGENTINA,BONN 4.627,1,CAPITAL,10E,ESTACION FLORES,11,1325,1335,3698
ESC MUNIC CESAR E ROMERO,PUBLICA S/N B°SACHI,1,CAPITAL,10E,ESTACION FLORES,5,1336,1340,1680
ESC AERONAUTICA ARGENTINA,ESMERALDA/CAP GRELLA B° MATIENZO,1,CAPITAL,10F,MATIENZO,10,1341,1350,3370
COL NUESTRA SEÑORA DE FATIMA,VARELA ORTIZ 2600 B° MATIENZO,1,CAPITAL,10F,MATIENZO,13,1351,1363,4380
ESC REPUBLICA ARGENTINA,SAN CAYETANO Y BRAILE B°AMEGHINO(S),1,CAPITAL,10F,MATIENZO,7,1364,1370,2352
ESC MIGUEL A ZABALA ORTIZ,DIAZ DE LA FUENTE 3101 B°MATIENZO,1,CAPITAL,10F,MATIENZO,7,1371,1377,2352
E.N.E.T. N° 4 COPERNICO,MARIANO MORENO 551 B° OBSERVATORIO,1,CAPITAL,10G,OBSERVATORIO,26,1378,1403,8840
EE UU DE NORTEAMERICA,LA PAMPA 550 B°P DE LOS ANDES,1,CAPITAL,10G,OBSERVATORIO,10,1404,1413,3400
COL   NUESTRA SEÑORA DE NIEVA,AYACUCHO 442 B° GUEMES,1,CAPITAL,10G,OBSERVATORIO,19,1414,1432,6445
ESC ADOLFO SALDIAS,BOLIVAR 896 B° GÜEMES,1,CAPITAL,10G,OBSERVATORIO,7,1433,1439,2373
ESC GDOR EMILIO OLMOS,AV FUERZA AEREA B°PARQUE CAPITAL,1,CAPITAL,10H,PARQUE CAPITAL,10,1440,1449,3409
ESC R ESCALADA DE SAN MARTIN,ESPORA 2283 B°ROSEDAL,1,CAPITAL,10H,PARQUE CAPITAL,13,1450,1462,4420
ESC MUNIC DR A DEL CASTILLO,UNO ESQ DOCE B°AMPL ROSEDAL,1,CAPITAL,10H,PARQUE CAPITAL,7,1463,1469,2380
IPEM 154 MARTIN M DE GUEMES,O NAVARRO 2.751,1,CAPITAL,10H,PARQUE CAPITAL,6,1470,1475,2040
PRIMARIA ELPIDIO TORRES,CALLE PUBLICA S/N,1,CAPITAL,10I,PARQUE HORIZONTE,12,1476,1487,4080
INST. SAN JOSE ARTESANO,CORONDA ESQ HUILICHES,1,CAPITAL,10I,PARQUE HORIZONTE,6,1488,1493,2040
IPEM 357 (SEC ELPIDIO TORRES),CALLE PUBLICA S/N,1,CAPITAL,10I,PARQUE HORIZONTE,11,1494,1504,3738
ESC BANDERA ARGENTINA,CASADO 634 STA ISABEL 1RA SECCION,1,CAPITAL,10J,SANTA ISABEL,11,1505,1515,3795
ESCUELA DON ORIONE,J.B.COTTOLENGO 1.955,1,CAPITAL,10J,SANTA ISABEL,11,1516,1526,3795
ESC MUNIC FERNANDEZ ORDOÑEZ,OLAVARRIA S/N° STA ISABEL 2DA SECC,1,CAPITAL,10J,SANTA ISABEL,6,1527,1532,2067
ESC.OSVALDO JORGE LEON,COLORADO ESQ LUAYABA,1,CAPITAL,10J,SANTA ISABEL,8,1533,1540,2752
ESC BENITO SORIA,BARBADOS Y HAITI B° VICOR,1,CAPITAL,10K,VICOR,15,1541,1555,4888
IPEM 313 (ANEX0),DEFENSA Y CACHEUTA.V.EL LIBERTADOR,1,CAPITAL,10L,VILLA EL LIBERTADOR,6,1556,1561,2046
ESC PROV DE SGO DEL ESTERO,CALLE 49 S/N° VILLA EL LIBERTADOR,1,CAPITAL,10L,VILLA EL LIBERTADOR,8,1562,1569,2728
ESC MARTA JUANA GONZALEZ,DEFENSA Y CACHEUTA B°V.EL LIBERTADOR 1.091,1,CAPITAL,10L,VILLA EL LIBERTADOR,10,1570,1579,3410
ESC MUNIC ALICIA MOREAU DE JUS,PILCOMAYO S/N°V EL LIBERTADOR,1,CAPITAL,10L,VILLA EL LIBERTADOR,8,1580,1587,2728
ESC PTE DR ARTURO U ILLIA,TOTORAL Y ARICA B°SANTA ROSA,1,CAPITAL,10L,VILLA EL LIBERTADOR,11,1588,1598,3751
COL SAN JOSE OBRERO,ARANI Y PJE. 17 V EL LIBERTADOR,1,CAPITAL,10L,VILLA EL LIBERTADOR,6,1599,1604,2046
J DE INF DR ARTURO U ILLIA,ARICA Y TOTORAL B°SANTA ROSA,1,CAPITAL,10L,VILLA EL LIBERTADOR,4,1605,1608,1364
ESC VICENTE FORESTIERI,ANIZACATE/CALLE 49 V. EL LIBERTADOR,1,CAPITAL,10L,VILLA EL LIBERTADOR,9,1609,1617,3069
IPEM 123BLANCA ECHEMENDI,IBARRA ESQUINA COSQUIN.VA.EL LIBERT.,1,CAPITAL,10L,VILLA EL LIBERTADOR,10,1618,1627,3404
ESC PATRICIAS MENDOCINAS,IBARRA ESQ FORESITERI,1,CAPITAL,10L,VILLA EL LIBERTADOR,4,1628,1631,1360
ESC PRIMARIA GRACIELA DEL RIO,B° AMPLIACION CABILDO,1,CAPITAL,10M,AMPLIACION CABILDO,5,1632,1636,1555
ESC ISABEL LA CATOLICA,SUBOF OTANO S/N° B° AERONAUTICO,1,CAPITAL,11,AERONAUTICO,14,1637,1650,4503
ESC PQUIAL SAN JOSE,VELEZ 252 B° ALTO ALBERDI,1,CAPITAL,11A,ALTO ALBERDI,12,1651,1662,4092
ESC SUP DE COMERCIO H VIEYTES,CASEROS Y VIEYTES B° ALTO ALBERDI,1,CAPITAL,11A,ALTO ALBERDI,10,1663,1672,3410
ESC BLAS PARERA,MONS DE ANDREA 1044 B° A ALBERDI,1,CAPITAL,11A,ALTO ALBERDI,7,1673,1679,2387
ESC SAN JOSE,CASEROS 3055 B° ALTO ALBERDI,1,CAPITAL,11A,ALTO ALBERDI,11,1680,1690,3740
ESC SAN LUIS GONZAGA,SANTA ROSA 2037 B° ALTO ALBERDI,1,CAPITAL,11A,ALTO ALBERDI,9,1691,1699,3060
ESC JOSE MARIA PAZ,AV COLON 2772 B° ALTO ALBERDI,1,CAPITAL,11A,ALTO ALBERDI,15,1700,1714,5100
ESC MOYANO COUDERT,DUARTE QUIROS 3950 ALTO ALBERDI,1,CAPITAL,11A,ALTO ALBERDI,4,1715,1718,1360
INSTITUTO TECNICO DON BOSCO,J VESPIGNANI 215 B° DON BOSCO,1,CAPITAL,11B,DON BOSCO,9,1719,1727,3023
ESC ANTARTIDA ARGENTINA,B° GENERAL DEHEZA,1,CAPITAL,11B,DON BOSCO,11,1728,1738,3685
ESC GRAL SAN MARTIN,AV COLON 4751 B°LAS PALMAS,1,CAPITAL,11C,LAS PALMAS,17,1739,1755,5865
ESC MANUEL E PIZARRO,DUARTE QUIROS 4725 B° LAS PALMAS,1,CAPITAL,11C,LAS PALMAS,14,1756,1769,4817
ESC MUNIC JUSTO PAEZ MOLINA,QUEBRACHO HERRADO Y YAVI LAS PALMAS,1,CAPITAL,11C,LAS PALMAS,7,1770,1776,2408
IPEM MARCELA B. MOYANO COUDERT,DUARTE QUIROS 3.915,1,CAPITAL,11C,LAS PALMAS,5,1777,1781,1720
INST JESUS MARIA,VIEYTES SUD 1607 B° LOS NARANJOS,1,CAPITAL,11D,LOS NARANJOS,18,1782,1799,6196
ESC REPUBLICA DEL PERU,GOYENA Y GOMEZ CARRILLO,1,CAPITAL,11D,LOS NARANJOS,12,1800,1811,4128
ESC SANTISIMA TRINIDAD,BLAMEY LAFORE 1248,1,CAPITAL,11D,LOS NARANJOS,7,1812,1818,2408
ESC B DE MONTEAGUDO,SAN LUIS 3450,1,CAPITAL,11E,LOS PLATANOS,12,1819,1830,4106
ESC JOSE MARMOL,AV LOS PLATANOS 1346,1,CAPITAL,11E,LOS PLATANOS,12,1831,1842,4104
ESC A CAPDEVILA,ALBERTO WILLIAMS ESQ.LOS PLATANOS,1,CAPITAL,11E,LOS PLATANOS,7,1843,1849,2394
ESC PADRE T GAMBINO,OCHO ESQ NUEVE B°LOS GRANADOS,1,CAPITAL,11E,LOS PLATANOS,10,1850,1859,3420
ESC.MUNIC.DR.CARLOS BECERRA,GAONA 1285,1,CAPITAL,11E,LOS PLATANOS,5,1860,1864,1710
IPEM 205 HUGO PALLADINO,27 DE ABRIL 5.330,1,CAPITAL,11F,LOS ROBLES,12,1865,1876,4010
ESC BATERIA LIBERTAD,POTRERILLO Y VENTA Y MEDIA,1,CAPITAL,11F,LOS ROBLES,10,1877,1886,3340
ESC PRIMER TTE AVILA,QUINCHAN 1.070,1,CAPITAL,11G,PARQUE REPUBLICA,8,1887,1894,2736
ESC PEREZ BULNES,J DE BARRIENTOS ESQ FORMOSA,1,CAPITAL,11G,PARQUE REPUBLICA,12,1895,1906,4104
ESC ATILIO ARGÜELLO,PUBLICA S/N B°PARQUE REPUBLICA,1,CAPITAL,11G,PARQUE REPUBLICA,10,1907,1916,3417
JARDIN TTE. AVILA,ALTO ALEGRE 1.050,1,CAPITAL,11G,PARQUE REPUBLICA,2,1917,1918,682
JORGE LUIS BORGES,ALTO ALEGRE/NAMUNCURA,1,CAPITAL,11G,PARQUE REPUBLICA,6,1919,1924,2046
ESC GABRIELA MISTRAL,27 DE ABRIL 5650 B°QUEB LAS ROSAS,1,CAPITAL,11H,QUEBRADA LAS ROSAS,10,1925,1934,3320
ESC REPUBLICA DE VENEZUELA,BOYERO 517,1,CAPITAL,11H,QUEBRADA LAS ROSAS,10,1935,1944,3319
ESC MUNIC LUZ VIEYRA MENDEZ,ABEL N DE CHAVEZ RES SAN ROQUE,1,CAPITAL,11I,RESIDENCIAL SAN ROQUE,10,1945,1954,3402
ESC MAURO FERNANDEZ,AV ALBARRACIN B°R SAN ROQUE 4.237,1,CAPITAL,11I,RESIDENCIAL SAN ROQUE,9,1955,1963,3060
J DE INF MAURO FERNANDEZ,GONZALEZ ALBARRACIN Y R ARIAS RSR,1,CAPITAL,11I,RESIDENCIAL SAN ROQUE,2,1964,1965,680
ESC.REPUBLICA DEL ECUADOR,HURTADO DE MENDOZA ESQ PEDRO ACUÑA,1,CAPITAL,11I,RESIDENCIAL SAN ROQUE,9,1966,1974,3060
HEROES DE MALVINAS,CNEL MANUEL NAMUNCURA/PETIROSSI,1,CAPITAL,11I,RESIDENCIAL SAN ROQUE,6,1975,1980,2040
INST. SEC. JUAN M. E ROSAS,CAMILOTTI ESQ SANTIBAÑEZ,1,CAPITAL,11I,RESIDENCIAL SAN ROQUE,8,1981,1988,2720
ESC ROMA,ECHEVERRIA 370 B°ALTO ALBERDI,1,CAPITAL,11J,SANTA ANA,17,1989,2005,5780
ESC LUTERANO CONCORDIA,SANTA ANA 2011 B°ALTO ALBERDI,1,CAPITAL,11J,SANTA ANA,16,2006,2021,5440
COLEGIO SAN JOSE,SOL DE MAYO 726 B° OBRERO,1,CAPITAL,11J,SANTA ANA,12,2022,2033,4080
ESC GENERAL MOSCONI,FERREYRA R 2324 B°OBRERO,1,CAPITAL,11J,SANTA ANA,6,2034,2039,2039
ESC EJERCITO ARGENTINO,LA RIOJA 3453,1,CAPITAL,11K,VILLA GRAL URQUIZA,8,2040,2047,2752
ESC MUNIC E BAQUERO LASCANO,HUMBERTO 1° ESQ IROS VILLA URQUIZA,1,CAPITAL,11K,VILLA GRAL URQUIZA,6,2048,2053,2064
ESC MUNIC JUAN B JUSTO,IGUALDAD 4100 VILLA URQUIZA,1,CAPITAL,11K,VILLA GRAL URQUIZA,6,2054,2059,2064
COL MADRE PAULA MONTAL,HUMBTO PRIMO Y FALUCHO V URQUIZA,1,CAPITAL,11K,VILLA GRAL URQUIZA,6,2060,2065,2064
IPEM 318 COMBATE DE LA TABLADA,LA TABLADA 4.861,1,CAPITAL,11K,VILLA GRAL URQUIZA,6,2066,2071,2060
INST.MARIA DE NAZARET,LOS ALAMOS (B° LA RUFINA) 1.111,1,CAPITAL,11L,COUNTRYS DEL OESTE,8,2072,2079,2576
ESC.S TURISMO Y HOT.M.PACHECO,AV.CARCANO (PREDIO FERIAR) 3.590,1,CAPITAL,11M,VALLE ESCONDIDO,7,2080,2086,2310
INSTITUTO VILLADA,,1,CAPITAL,11M,VALLE ESCONDIDO,5,2087,2091,1650
ESC JUAN XXIII,BENAVIDEZ Y CANESA,1,CAPITAL,12,AVELLANEDA,12,2092,2103,4020
ESC CONSTANCIO C VIGIL,J.LLERENA 5561,1,CAPITAL,12,AVELLANEDA,8,2104,2111,2679
ESC MUNIC OSCAR SOTO LOPEZ,LOS ALGARROBOS/ESPINILLOS,1,CAPITAL,12,AVELLANEDA,6,2112,2117,2004
ESC.PROF.M.LUCIANI,11 DE SEPTIEMBRE ESQ. CALLE 2CARCANO 4.400,1,CAPITAL,12A,CARCANO,8,2118,2125,2752
ESC.MA.DEL TRANSITO CABANILLAS,CNO.SAN ANDRES/RUIZ HUIDOBRO,1,CAPITAL,12A,CARCANO,8,2126,2133,2745
ESC RUBEN DARIO,LA CORUÑA Y MONSERRAT B°CRISOL,1,CAPITAL,12B,COLON,13,2134,2146,4459
INST NTRA SRA DEL SGDO CORAZON,REVOLUCION DE MAYO 1476 B°COLON,1,CAPITAL,12B,COLON,17,2147,2163,5826
ESC BARTOLOME HIDALGO,TEJEDOR 1958 B°SARMIENTO,1,CAPITAL,12B,COLON,7,2164,2170,2394
ESC JUAN LARREA,LUIS BRAILE 2273 B°SARMIENTO,1,CAPITAL,12B,COLON,8,2171,2178,2736
ESC HILARIO ASCASUBI,LUCIO V.MANSILLA ESQ. CADIZ,1,CAPITAL,12B,COLON,10,2179,2188,3420
INST MANUEL BELGRANO,LUIS BRAILE 2384 B°SARMIENTO,1,CAPITAL,12B,COLON,8,2189,2196,2736
ESC DR LUIS A CAEIRO,ORTIZ Y HERRERA 1932 B°CRISOL N,1,CAPITAL,12B,COLON,4,2197,2200,1368
ESC CORONEL OLMEDO,ALTOLAGUIRRE B°CNEL OLMEDO 4.060,1,CAPITAL,12C,CORONEL OLMEDO,14,2201,2214,4524
ESC MONSEÑOR M DE ANDREA,17 DE JULIO 380 B°FVRO MITRE,1,CAPITAL,12D,JOSE IGNACIO DIAZ,10,2215,2224,3430
ESC PEDRO GOYENA,PJE GUASTONI 3472 B° BRIG S MARTIN,1,CAPITAL,12D,JOSE IGNACIO DIAZ,13,2225,2237,4459
ESC MUNICIPAL DR A SABATTINI,DIEGO DE PACHECO 4.900,1,CAPITAL,12D,JOSE IGNACIO DIAZ,8,2238,2245,2744
ESC MUNIC DR ARTURO H ILLIA,CHIRINO DE POSADAS ESQ.MAGUNA 4.600,1,CAPITAL,12D,JOSE IGNACIO DIAZ,8,2246,2253,2740
ESC MUNIC DOMINGO F SARMIENTO,MANZANA 63. B° 23 DE ABRIL(CNOINTERF,1,CAPITAL,12D,JOSE IGNACIO DIAZ,7,2254,2260,2394
CENTRO EDUC.ING.REGINO M.MADER,CHIRINO DE POSADAS 5400 B°S.FELIPE,1,CAPITAL,12D,JOSE IGNACIO DIAZ,8,2261,2268,2736
POETA OSCAR GUIÑAZU ALVAREZ,ASTURIAS 3.345,1,CAPITAL,12D,JOSE IGNACIO DIAZ,8,2269,2276,2736
IPEM N° 309 (FUENTEALBA),CALLE PUBLICA,1,CAPITAL,12D,JOSE IGNACIO DIAZ,6,2277,2282,2052
ESC. MARIA EVA DUARTE,CALLE PUBLICA S/N (CNO 60 CUAD KM3),1,CAPITAL,12D,JOSE IGNACIO DIAZ,6,2283,2288,2052
ESC REPUBLICA DE COSTA RICA,RUTA 9 KM 8 1/2,1,CAPITAL,12E,FERREYRA,5,2289,2293,1705
ESC LIBERTADOR GRAL S MARTIN,SGO MORALES 4400 B°FERREYRA,1,CAPITAL,12E,FERREYRA,9,2294,2302,3069
ESC MUNIC E MOLINARI ROMERO,PAMPAYASTA Y RUMIPAL B°PQUE SCARLOS,1,CAPITAL,12F,JOSE HERNANDEZ,9,2303,2311,3105
ESC MUNIC BRIG JUAN I DE S MAR,BRAGADO/TRENQUE LAUQUEN B°J HERNDEZ,1,CAPITAL,12F,JOSE HERNANDEZ,7,2312,2318,2415
ESC GRAL MANUEL BELGRANO,OLAEN Y AMBOY,1,CAPITAL,12F,JOSE HERNANDEZ,11,2319,2329,3795
ESC EJERCITO ARGENTINO,CASTAÑARES 470,1,CAPITAL,12F,JOSE HERNANDEZ,8,2330,2337,2760
COL.JOVENES ARGENTINOS,BOTAFOGO 3448 B° J.ESPINOSA,1,CAPITAL,12F,JOSE HERNANDEZ,7,2338,2344,2410
IPEM 167 JOSE MANUEL ESTRADA,B. DE O'HIGGINS 2.656,1,CAPITAL,12F,JOSE HERNANDEZ,10,2345,2354,3440
ESCUELA ADVENTISTA HECTOR RHYS,TANINGA 3.152,1,CAPITAL,12F,JOSE HERNANDEZ,5,2355,2359,1720
ESC PRIMARIA CARLOS M DE ALVEA,VUCETICH 6410 B°ITUZAINGO,1,CAPITAL,12G,ITUZAINGO,7,2360,2366,2387
ESC EJERCITO ARGENTINO,STEPHENSON Y FULTON B°ITUZAINGO,1,CAPITAL,12G,ITUZAINGO,14,2367,2380,4761
ESC SECUNDARIA CARLOS M DE ALV,FARADAY 5721 B°LOS EUCALIPTUS,1,CAPITAL,12G,ITUZAINGO,6,2381,2386,2040
ESC DR IGNACIO DUARTE QUIROS,FARADAY 5.168,1,CAPITAL,12G,ITUZAINGO,4,2387,2390,1360
ESC MADRE TERESA DE CALCUTA,PALAMARA 2.900,1,CAPITAL,12H,LOS CERVECEROS,8,2391,2398,2688
ESC RAUL A FERREYRA,PUBLICA S/N -ALTURA AV O'HIGGINS 3.500,1,CAPITAL,12H,LOS CERVECEROS,8,2399,2406,2688
ESC JOSE M ESTRADA,AV B DE O'HIGGINS KM 8 1/2,1,CAPITAL,12H,LOS CERVECEROS,6,2407,2412,2016
J DE INF RAUL A.FERREYRA,B DE O'HIGGINS 3500 B°S.E.P,1,CAPITAL,12H,LOS CERVECEROS,3,2413,2415,1008
ESC.DR.NICOLAS AVELLANEDA,CNO.S.CARLOS KM. 4 1/2,1,CAPITAL,12H,LOS CERVECEROS,6,2416,2421,2015
ESC. PRIMARIA MARIA SALEME,RUTA 9 KM 690,1,CAPITAL,12I,CIUDAD DE MIS SUEÑOS,7,2422,2428,2326
ESC PADRE DIEGO DE TORRES,DIAG ICA Y CAMICALTA B°L N ALEM,1,CAPITAL,13,LEANDRO N. ALEM,12,2429,2440,4111
ESC ARISTOBULO DEL VALLE,M DE JAUREGUI 1657 B°L N ALEM,1,CAPITAL,13,LEANDRO N. ALEM,10,2441,2450,3420
ESC ASOCIACION DE MAYO,COLOMPREA 1500 B° ALEM,1,CAPITAL,13,LEANDRO N. ALEM,5,2451,2455,1710
ESC HENOCH D AGUIAR,J DE OLMEDO 650 B°LOS GIGANTES,1,CAPITAL,13A,AYACUCHO,10,2456,2465,3440
ESC FRANCISCO A RIZZUTO,FDO DE LESSEPS 140 B°CENTRO AMERICA,1,CAPITAL,13A,AYACUCHO,13,2466,2478,4464
ESC R SANCHEZ DE CALDELARI,ALVAREZ DE LAS CASAS 280   AYACUCHO,1,CAPITAL,13A,AYACUCHO,10,2479,2488,3430
ESC P ALBARRACIN DE SARMIENTO,NERUDA Y ACAMPES B° VILLA AZALAIS,1,CAPITAL,13A,AYACUCHO,11,2489,2499,3773
ESC MUNIC DR P CARANDE CARRO,MARTINEZ PAZ 80 B°CENTRO AMERICA,1,CAPITAL,13A,AYACUCHO,5,2500,2504,1715
ESC FLORENCIO SANCHEZ,RUTA 111 KM 12,1,CAPITAL,13B,EL GATEADO,1,2505,2505,146
ESC CAPITAL FEDERAL,MAURICIO YADAROLA 653 B°GRAL BUSTOS,1,CAPITAL,13C,GENERAL BUSTOS,11,2506,2516,3718
ESC CRISTO REY,CURA BROCHERO B°GRAL BUSTOS 753,1,CAPITAL,13C,GENERAL BUSTOS,7,2517,2523,2366
ESC ALEJO CARMEN GUZMAN,AUGUSTO LOPEZ 643 B°GRAL BUSTOS,1,CAPITAL,13C,GENERAL BUSTOS,13,2524,2536,4384
COLEGIO HORTUS CONCLUSUS,GIANELLI 500 B°GRAL BUSTOS,1,CAPITAL,13C,GENERAL BUSTOS,10,2537,2546,3370
ESC MUNIC J GONZALEZ,CINCO S/N°B°JARDIN ARENALES,1,CAPITAL,13D,JARDIN ARENALES,8,2547,2554,2553
ESC REPUBLICA DE LA INDIA,CNO MONTE CRISTO KM 5,1,CAPITAL,13E,LA DOROTEA,4,2555,2558,1215
ESC MODELO RACING,TREDENTINA B°NUEVA ITALIA 2.160,1,CAPITAL,13F,NUEVA ITALIA,11,2559,2569,3740
ESC SGTO CABRAL,P DE LEDESMA B°PQUE MTE CRISTO 1.755,1,CAPITAL,13F,NUEVA ITALIA,10,2570,2579,3397
CENTRO VECINAL ZONA 111,TREDENTINA 1945 B°NUEVA ITALIA,1,CAPITAL,13F,NUEVA ITALIA,2,2580,2581,678
ESC RICARDO ROJAS,STORNI Y MONTALVO B°LICEO 2DA SECC,1,CAPITAL,13G,PARQUE LICEO,14,2582,2595,4760
ESC ESPIRITU SANTO,ISAAC 4.847,1,CAPITAL,13G,PARQUE LICEO,25,2596,2620,8480
ESC MUNIC GDOR A ZANICHELLI,STORNI S/N B°PQUE LICEO 3RA SECC,1,CAPITAL,13G,PARQUE LICEO,7,2621,2627,2373
ESC. PRIMARIA EVA DUARTE,BARTOLOME HIDALGO 1.140,1,CAPITAL,13G,PARQUE LICEO,7,2628,2634,2373
ESC JOSE MARIA PAZ,USANDIVARAS 2254 B°PATRICIOS,1,CAPITAL,13H,PATRICIOS,11,2635,2645,3740
COL HIJAS DE MARIA INMACULADA,MADRE BRIGIDA PASTORINO 2.733,1,CAPITAL,13H,PATRICIOS,15,2646,2660,5095
ESC PARROQUIAL SAN ROQUE,USANDIVARAS 2050 VILLA CORINA,1,CAPITAL,13H,PATRICIOS,8,2661,2668,2712
ESC MANUEL BELGRANO,ABRAMO 2545 B°BELGRANO,1,CAPITAL,13H,PATRICIOS,12,2669,2680,4068
ESC MUNIC DR D LATELLA FRIAS,H DE AYOHUMA S/N B°PATRICIOS,1,CAPITAL,13H,PATRICIOS,5,2681,2685,1695
ESC MUNIC JORGE LUIS BORGES,QUINTA SAN JORGE,1,CAPITAL,13I,SAN JORGE,7,2686,2692,2345
ESC MUNIC DR ALFREDO ORGAZ,PUBLICA S/N B°QTAS SAN JORGE II,1,CAPITAL,13I,SAN JORGE,7,2693,2699,2343
ESC MUNIC. MONSEÑOR ANGELELLI,FEDERICO RAUCH 2.790,1,CAPITAL,13I,SAN JORGE,4,2700,2703,1336
ESC A CAPDEVILA/ DR. B HOUSEY,A CAPDEVILA 709 Y BILIBISACATE,1,CAPITAL,13J,VILLA AZALAIS,11,2704,2714,3762
ESC CURA BROCHERO,JAMAICA 967 B°RESID AMERICA,1,CAPITAL,13J,VILLA AZALAIS,12,2715,2726,4104
ESC GDOR H DEL CASTILLO,GELLY Y OBES 3110 VILLA AZALAIS,1,CAPITAL,13J,VILLA AZALAIS,9,2727,2735,3078
ESC PARROQUIAL L STUCCHI BAUDO,NUEVO MUNDO 824 B°RESID AMERICA,1,CAPITAL,13J,VILLA AZALAIS,11,2736,2746,3753
ESC JUSTO PAEZ MOLINA,J MONTAÑO 1350 B° VILLA AZALAIZ,1,CAPITAL,13J,VILLA AZALAIS,14,2747,2760,4774
ESC VICENTE F LOPEZ,TISSERA 1551 B° L N ALEM,1,CAPITAL,13J,VILLA AZALAIS,15,2761,2775,5115
ESC MUNIC J A PAREDES,FCO DEL PRADO 3900 V AZALAIS,1,CAPITAL,13J,VILLA AZALAIS,8,2776,2783,2728
I.P.E.T N° 70,AV JUAN B JUSTO 4.350,1,CAPITAL,13J,VILLA AZALAIS,11,2784,2794,3751
DR JOSE RAMON IBAÑEZ,CAPDEVILLA KM 9 1/2,1,CAPITAL,13K,VILLA ESQUIU,7,2795,2801,2110
ESC JORGE WASHINGTON ABALOS,CNO J MARIA KM 8 1/2,1,CAPITAL,13L,VILLA GRAN PARQUE,2,2802,2803,420
ESC OLEGARIO V ANDRADE,CNO SGO DEL ESTERO KM 7 1/2,1,CAPITAL,13M,CAMINO A COLONIA TIROLESA,2,2804,2805,460
ESC DR ANTONIO NORES,JULIO DE VEDIA 2.353,1,CAPITAL,13N,YOFRE,13,2806,2818,4429
ESC MATEO J LUQUE,JACINTO DE ALTOLAGUIRRE B°YOFRE NORT 2.089,1,CAPITAL,13N,YOFRE,9,2819,2827,3060
ESC. CARLOS TAGLE ACHAVAL,MANZANA 22 B°CIUDAD DE LOS CUARTETOS,1,CAPITAL,13O,CHACHAPOYAS,4,2828,2831,1265
COLEGIO LA SALLE,AV MARTINOLI 3950,1,CAPITAL,14,ARGUELLO,14,2832,2845,4662
COLEGIO DEL CARMEN,RECTA MARTINOLI B°ARGÜELLO,1,CAPITAL,14,ARGUELLO,6,2846,2851,1994
ESC BRIG SAN MARTIN,DOMINGO MARIMON/GABRIEL ORTEGA,1,CAPITAL,14A,ARGUELLO NORTE,15,2852,2866,5086
ESC RICARDO NASSIF,MARTIN FERMIN B°ARGÜELLO NORTE,1,CAPITAL,14A,ARGUELLO NORTE,13,2867,2879,4407
ESC HUGO LEONELLI,ALBERTO FAGE/JULIO BEJANELE,1,CAPITAL,14A,ARGUELLO NORTE,10,2880,2889,3390
ESC MARTHA A SALOTTI,PUBLICA S/N IPV SECTOR360ARGÜELLO N,1,CAPITAL,14A,ARGUELLO NORTE,13,2890,2902,4407
ESC MARTIN DE GÜEMES,MONTUFAR Y CORONADO 7.126,1,CAPITAL,14B,ARGUELLO PRIMERO,8,2903,2910,2664
ESC MUNIC RAUL V MARTINEZ,NILO PECANHA S/N B°QTAS DE ARGÜELLO,1,CAPITAL,14B,ARGUELLO PRIMERO,8,2911,2918,2660
ESC ELISA K DE LIVACK,CUIMAN B°LA SALLE 6.543,1,CAPITAL,14B,ARGUELLO PRIMERO,6,2919,2924,1992
INST CONCEPCIONISTA LA INMACUL,AV ENRIQUE BODEREAU KM 14,1,CAPITAL,14C,ARGUELLO SEGUNDO,14,2925,2938,4650
ESC INGENIERO VICTOR REE,FDO FADER 3821 B°C DE LAS ROSAS,1,CAPITAL,14D,CERRO DE LAS ROSAS,9,2939,2947,3099
ESC JUAN ZORRILA DE SAN MARTIN,JOSE E BUSTOS 1875 C DE LAS ROSAS,1,CAPITAL,14D,CERRO DE LAS ROSAS,11,2948,2958,3784
ESC MODESTA RODRIGUEZ,HNOS GRIMM 7168 B°UOCRA,1,CAPITAL,14E,CERRO NORTE,5,2959,2963,1703
ESC NIÑAS DE AYOHUMA,VALERIO BETA B°ARGUELLO (N) 7.300,1,CAPITAL,14E,CERRO NORTE,9,2964,2972,3060
ESC GERONIMO GRAGERA,MOLLEYACO/PAYEN,1,CAPITAL,14E,CERRO NORTE,5,2973,2977,1700
ESC DR ALEJANDRO GALLARDO,TRINIDAD ESQ ITALIA B°SILVANO FUNES,1,CAPITAL,14F,GRANJA DE FUNES,11,2978,2988,3688
ESC JAVIER LAZCANO COLODRERO,CARLOS BROGGI S/N° B°ARGÜELLO,1,CAPITAL,14F,GRANJA DE FUNES,9,2989,2997,3015
ESC MUNIC ING MASJOAN,2/TUCUMAN Y MENDOZA LOS BOULEVARES,1,CAPITAL,14G,LOS BOULEVARES,9,2998,3006,3015
ESC JUAN MARIA GUTIERREZ,BV LOS ALEMANES 4.200,1,CAPITAL,14G,LOS BOULEVARES,9,3007,3015,3007
ESC. F. LELOIR,LOS POLACOS 6.072,1,CAPITAL,14G,LOS BOULEVARES,9,3016,3024,3006
ESC ARTEMIO ARAN,PUBLICA ESQ JACINTO YABEN,1,CAPITAL,14H,MERCANTIL,6,3025,3030,1968
ESC MUNIC MAESTRO M OLIVA,REVELTO ESQ TOMASINI B°MERCANTIL,1,CAPITAL,14H,MERCANTIL,5,3031,3035,1638
ESC MAESTROS PUNTANOS,CINCO N°25 B°AMPL P LUGONES,1,CAPITAL,14I,SANTA CECILIA,7,3036,3042,2402
ESC MUNIC ARSENIO MURUGARREN,PIZARRO Y GRASS B°SANTA CECILIA,1,CAPITAL,14I,SANTA CECILIA,8,3043,3050,2744
INSTITUTO EMILIO LAMARCA,AV EMILIO LAMARCA 4.245,1,CAPITAL,14J,URCA,9,3051,3059,3024
ESC REPUBLICA DE PANAMA,TRECE BIS   COL   DEL CERRO,1,CAPITAL,14J,URCA,7,3060,3066,2352
ESC REPUBLICA DEL LIBANO,IGARZABAL 1250 B°URCA,1,CAPITAL,14J,URCA,8,3067,3074,2687
ESC MUNIC DR RAUL FERNANDEZ,12 Y 14 VILLA ALLENDE PQUE,1,CAPITAL,14K,VILLA ALLENDE PARQUE,8,3075,3082,2619
JARDIN MATERNAL TRAVESURAS,MULUCHES S/N,1,CAPITAL,14K,VILLA ALLENDE PARQUE,3,3083,3085,981
ESC NUEVA JUAN MANTOVANI,AVOGADRO Y GAUSS VILLA BELGRANO,1,CAPITAL,14L,VILLA BELGRANO,8,3086,3093,2656
ESC RICARDO PALMA,D'ALEMBERT Y GAUSS,1,CAPITAL,14L,VILLA BELGRANO,8,3094,3101,2654
INST   SAUL TABORDA,OB MOSCOSO Y PERALTA 2772 A PALERMO,1,CAPITAL,14M,VILLA CENTENARIO,13,3102,3114,4355
ESC PRIMERA JUNTA,C DE ARREDONDO 4446 B°CENTENARIO,1,CAPITAL,14M,VILLA CENTENARIO,13,3115,3127,4347
ESC LUZ VIEYRA MENDEZ,OB MOSCOSO Y PERALRA 2772,1,CAPITAL,14M,VILLA CENTENARIO,3,3128,3130,1002
ESC MUNIC DR HORACIO GARCIA,PUBLICA S/N°V CORNU,1,CAPITAL,14N,VILLA CORNU,9,3131,3139,2966
IPEM 16 MA.SALEME DE BURNICHON,AL LADO ESC. H. GARCIA,1,CAPITAL,14N,VILLA CORNU,7,3140,3146,2303
INSTITUTO LEON XIII,AV BODEREAU 7.850,1,CAPITAL,14O,VILLA 9 DE JULIO,16,3147,3162,5274
ESC MUNIC SAUL TABORDA,COQUENA (VILLA 9 DE JULIO) 7.985,1,CAPITAL,14O,VILLA 9 DE JULIO,6,3163,3168,1974
ESC MUNIC DR JORGE ORGAZ,LAGUNA LARGA/R LUNA V R INDARTE,1,CAPITAL,14P,VILLA RIVERA INDARTE,7,3169,3175,2353
IPEM N° 17,LAGUNA LARGA ESQ.RINCON DE LUNA,1,CAPITAL,14P,VILLA RIVERA INDARTE,4,3176,3179,1344
INST. TEC. ISAAC NEWTON,MOLINO DE TORRES 6.635,1,CAPITAL,14Q,VILLA WARCALDE,4,3180,3183,1168
ESC PROV D VELEZ SARFIELD,AYLLU,2,CALAMUCHITA,15,AMBOY,1,3184,3184,240
ESC.PROV.R.SAENZ PEÑA,CALLE 6,2,CALAMUCHITA,15A,VILLA AMANCAY,2,3185,3186,505
ESC PROV. M.BELGRANO,PUBLICA S/N,2,CALAMUCHITA,16,ATHOS PAMPA,1,3187,3187,151
ESCUELA N° 404,VILLA LA MERCED,2,CALAMUCHITA,16A,VILLA LA MERCED,1,3188,3188,34
ESC.PROV. F.AMEGHINO,CHAMPAQUI,2,CALAMUCHITA,16B,CHAMPAQUI,1,3189,3189,12
ESC. JOAQUIN V. GONZALEZ,PUBLICA,2,CALAMUCHITA,16C,VILLA BERNA,1,3190,3190,106
IPEA Y T 347,J LUIS DE CABRERA ESQ ACONCAGUA,2,CALAMUCHITA,17,EMBALSE,12,3191,3202,4062
ESCUELA B. ROLDAN,TUCUMAN 121,2,CALAMUCHITA,17,EMBALSE,9,3203,3211,3042
ESC PROV DOMINGO F SARMIENTO,SARMIENTO 376,2,CALAMUCHITA,18,LA CRUZ,3,3212,3214,922
INST DR D VELEZ SARSFIELD,SARMIENTO 236,2,CALAMUCHITA,18,LA CRUZ,2,3215,3216,614
ESC. PROV. L. LUGONES,PUBLICA,2,CALAMUCHITA,18A,LUTTI,1,3217,3217,157
ESCUELA PROVINCIAL,CALERAS DE CALAMUCHITA,2,CALAMUCHITA,18B,CALERAS DE CALAMUCHITA,1,3218,3218,202
ESC.PROV. A.ALSINA,FRANCISCO CESAR,2,CALAMUCHITA,18C,VILLA CAÑADA DEL SAUCE,1,3219,3219,80
ESC.PROV.PADRE FELIX ENRIQUE,VILLA QUILLINZO,2,CALAMUCHITA,18D,VILLA QUILLINZO,1,3220,3220,160
ESC. PROV. FRENCH Y BERUTTI,LOS CONDORES,2,CALAMUCHITA,19,LOS CONDORES,5,3221,3225,1575
COLEGIO SAGRADO CORAZON,AV DON BOSCO 101,2,CALAMUCHITA,19,LOS CONDORES,4,3226,3229,1258
ESC PROV PEDRO B PALACIOS,MANUEL BELGRANO S/N,2,CALAMUCHITA,20,LOS REARTES,4,3230,3233,1328
ESC.GRAL J. DE SAN MARTIN,VILLA GRAL.BELGRANO,2,CALAMUCHITA,20A,VILLA GENERAL BELGRANO,9,3234,3242,3069
ESC. DE COM. D. DE ROJAS,VILLA GRAL.BELGRANO,2,CALAMUCHITA,20A,VILLA GENERAL BELGRANO,8,3243,3250,2728
COLEGIO ARGENTINO GERMANO,VILLA GRAL.BELGRANO,2,CALAMUCHITA,20A,VILLA GENERAL BELGRANO,5,3251,3255,1704
ESC ELOY GOMEZ ANEXO (PRIMARIA,VILLA CIUDAD PQUE LOS REARTES,2,CALAMUCHITA,20B,VI.CIUD.PQUE.LOS REARTES,4,3256,3259,1095
ESC. DR. JUAN M. ALBARENQUE,PUBLICA,2,CALAMUCHITA,21,LAS BAJADAS,1,3260,3260,269
ESC. PROV. D.F. SARMIENTO,SARMIENTO,2,CALAMUCHITA,22,RIO DE LOS SAUCES,4,3261,3264,1109
ESC.PROV. FRENCH Y BERUTTI,CORDOBA,2,CALAMUCHITA,23,VILLA YACANTO,5,3265,3269,1443
ESC PROV PRIMERA JUNTA,AMADEO SABATTINI 143,2,CALAMUCHITA,24,RUMIPAL,8,3270,3277,2439
ESC.PROV.ALMIRANTE BROWN,SARMIENTO 279,2,CALAMUCHITA,24A,VILLA DEL DIQUE,10,3278,3287,3325
ESC. PROV.GRAL. SAN MARTIN,SAN AGUSTIN,2,CALAMUCHITA,25,SAN AGUSTIN,5,3288,3292,1705
COLEGIO SAN JOSE,SAN AGUSTIN,2,CALAMUCHITA,25,SAN AGUSTIN,4,3293,3296,1361
ESC.PROV.M.GUEMES,PUBLICA,2,CALAMUCHITA,25A,CALMAYO,1,3297,3297,126
ESC PROV JUAN LARREA,PUBLICA S/N,2,CALAMUCHITA,25B,LOS MOLINOS,1,3298,3298,301
INST PARR SAN JUAN DIEGO,AV INT ANGEL LLANOS 320,2,CALAMUCHITA,26,SANTA ROSA,10,3299,3308,3430
PRIM-EL MUNDO DE LOS CHICOS,GUEMES 162,2,CALAMUCHITA,26,SANTA ROSA,5,3309,3313,1712
ESC. PROV.M. MORENO,SANTA ROSA,2,CALAMUCHITA,26,SANTA ROSA,10,3314,3323,3420
COLEGIO NAC. DR.D.V. SARSFIELD,SANTA ROSA,2,CALAMUCHITA,26,SANTA ROSA,9,3324,3332,3078
ESCUELA N° 481,SEGUNDA USINA,2,CALAMUCHITA,26A,SEGUNDA USINA,1,3333,3333,131
ESC.PROV.DEAN FUNES,SAN IGNACIO,2,CALAMUCHITA,26B,SAN IGNACIO,1,3334,3334,130
ESC BARTOLOME MITRE,PUBLICA S/N,2,CALAMUCHITA,328A,LA CUMBRECITA,3,3335,3337,762
ESCUELA DR. PABLO RUEDA,LA GRANJA,3,COLON,27,ASCOCHINGA,6,3338,3343,1880
ESC ING ALBERTO R MASCIAS,PUBLICA S/N,3,COLON,27,ASCOCHINGA,4,3344,3347,1252
ESC ELADIO DIEZ,ALVEAR ESQ SARMIENTO,3,COLON,28,CALERA,8,3348,3355,2736
IPEM N° 73,REP DE CHILE ESQ GRAL CABRERA,3,COLON,28,CALERA,8,3356,3363,2736
INSTITUTO D.F.SARMIENTO,CALERA,3,COLON,28,CALERA,17,3364,3380,5814
ESCUELA PROV.J.J.PASO-CENMA,CALERA,3,COLON,28,CALERA,11,3381,3391,3762
INSTITUTO JESUS MARIA,CALERA,3,COLON,28,CALERA,7,3392,3398,2391
JARDIN IBARSABAL,RONDEAU 814,3,COLON,28A,CALERA CENTRAL,3,3399,3401,1026
ESC.TTE. J.R. IBARZABAL,CALERA CENTRAL,3,COLON,28A,CALERA CENTRAL,15,3402,3416,5130
CENTRO EDUCATIVO GRAL SAN MART,CALERA CENTRAL,3,COLON,28A,CALERA CENTRAL,9,3417,3425,3076
EX ANEXO MARGARITA W DE PAZ,AVELLANEDA 684,3,COLON,28A,CALERA CENTRAL,9,3426,3434,3069
COLEGIO PIO LEON,AV 28 DE JULIO 345,3,COLON,29,COLONIA CAROYA,12,3435,3446,4080
ESC.PROV. M. BELGRANO,COLONIA CAROYA,3,COLON,29,COLONIA CAROYA,10,3447,3456,3400
ESC. PROV. GRAL SAN MARTIN,MAESTRA OLGA PROSDOCIMO 3.580,3,COLON,29,COLONIA CAROYA,10,3457,3466,3400
ESC. PRESBITERO BONORIS,COLONIA CAROYA,3,COLON,29,COLONIA CAROYA,11,3467,3477,3737
ESCUELA M. MORENO,JUSTINIANO CELIZ HEREDIA 650,3,COLON,29,COLONIA CAROYA,6,3478,3483,2034
ESC.PROV.B.RIVADAVIA,PUBLICA,3,COLON,29A,TINOCO,1,3484,3484,263
IPET 83 RENE FAVALORO,ARTURO ILLIA 505,3,COLON,30,COLONIA TIROLESA,9,3485,3493,2991
ESC PROV DR PABLO RUEDA,PUBLICA S/N,3,COLON,30,COLONIA TIROLESA,7,3494,3500,2324
ESC.PROV.A.ARGENTINA,EL MANZANO SOBRE RUTA E 53,3,COLON,31,EL MANZANO,4,3501,3504,1129
ESC.PROV.V.MERCANTE,AGUA DE ORO,3,COLON,31A,AGUA DE ORO,4,3505,3508,1269
INST SECUNDARIO AGUA DE ORO,AV BELGRANO S/N,3,COLON,31A,AGUA DE ORO,3,3509,3511,951
LOCAL COMUNAL,VILLA CERRO AZUL,3,COLON,31B,VILLA CERRO AZUL,2,3512,3513,363
ESC PROV GRAL JOSE MARIA PAZ,BUENOS AIRES Y CORDOBA,3,COLON,32,GENERAL PAZ,6,3514,3519,1863
PTE DOMINGO F SARMIENTO,CORDOBA (PARALEA A JUAN B JUSTO) 1.050,3,COLON,33,JESUS MARIA,14,3520,3533,4802
I.P.E.T.N° 69,JESUS MARIA,3,COLON,33,JESUS MARIA,13,3534,3546,4453
ESC.DR. J.M.ESTRADA N° 221,CATAMARCA Y ESTRADA,3,COLON,33,JESUS MARIA,13,3547,3559,4446
ESC.PROV.1ER.TTE.MORANDINI,CHILE -SAN JOSE OBRERO 222,3,COLON,33,JESUS MARIA,12,3560,3571,4104
ESC.PROVC.F.O. DE OCAMPO,AV. DR. FRANCISCO N. DE LAPRIDA 649 649,3,COLON,33,JESUS MARIA,14,3572,3585,4788
COL.NTA.SRA. DEL HUERTO,JESUS MARIA,3,COLON,33,JESUS MARIA,7,3586,3592,2394
ESC.N°21 GENDARMERIA NACIONAL,JESUS MARIA,3,COLON,33,JESUS MARIA,10,3593,3602,3420
ESC PROV VICENTE AGUERO,LOTE XVII S/N,3,COLON,33A,COLONIA VICENTE AGÜERO,1,3603,3603,277
ESC PROV LEOPOLDO LUGONES,VILLA LOS LLANOS,3,COLON,34,JUAREZ CELMAN,9,3604,3612,3063
ESC.COMODORO R. SILIONI,AV. ACONCAGUA S/N,3,COLON,34,JUAREZ CELMAN,12,3613,3624,4080
ESC.ATAHUALPA YUPANQUI,BARRIO PARQUE NORTE,3,COLON,34,JUAREZ CELMAN,8,3625,3632,2720
ESC.CAP.LUIS C.CANDELARIA,MALVINAS ARGENTINAS,3,COLON,35,MALVINAS ARGENTINAS,10,3633,3642,3410
ESC.MUNIC.CIUDAD DE M.ARGENTIN,MALVINAS ARGENTINAS,3,COLON,35,MALVINAS ARGENTINAS,9,3643,3651,3069
I.P.E.M. N° 24,JUJUY ESQ. SARMIENTO S/N MALVINAS AR,3,COLON,35,MALVINAS ARGENTINAS,16,3652,3667,5449
JARDIN DE INF.CAP.CANDELARIA,VILLAFAÑE DEL VISO,3,COLON,35A,MI GRANJA,3,3668,3670,915
ESC PROV SARGENTO CABRAL,PUBLICA S/N,3,COLON,36,LA PUERTA,2,3671,3672,347
IPEM N° 352,NICANOR CEBALLOS,3,COLON,37,RIO CEBALLOS,13,3673,3685,4407
ESC.PROV.M.FRAGUEIRO,AVENIDA SAN MARTIN 4.519,3,COLON,37,RIO CEBALLOS,13,3686,3698,4407
I.P.E.M.144-MARIANO MORENO,SALTA 191,3,COLON,37,RIO CEBALLOS,10,3699,3708,3390
INSTITUTO DEL ESPIRITU SANTO,AV. SAN MARTIN 5.109,3,COLON,37,RIO CEBALLOS,12,3709,3720,4065
ESC.CONSTANCIO C. VIGIL,1 MAYO B° MOREYRA 112,3,COLON,37,RIO CEBALLOS,6,3721,3726,2028
INST SECUNDARIO SALSIPUEDES,AV BELGRANO 178,3,COLON,38,SALSIPUEDES,8,3727,3734,2688
ESC.PROV. J.MALDONADO,DESIDERIO TORRES 360,3,COLON,38,SALSIPUEDES,12,3735,3746,4032
ESCUELA RECONQUISTA,CERRITO,3,COLON,38,SALSIPUEDES,6,3747,3752,2013
ESC.PROV. FRAY M.ESQUIU,PUBLICA,3,COLON,39,SANTA TERESA,1,3753,3753,63
INST.NTA.SRA.DE LAS MERCEDES,AZOPARDO 200,3,COLON,40,UNQUILLO,9,3754,3762,3105
ESC.PROV. D.V.SARSFIELD,SARMIENTO Y VELEZ SARSFIELD,3,COLON,40,UNQUILLO,8,3763,3770,2760
I.P.E.M. N° 23,SPILIMBERGO 869,3,COLON,40,UNQUILLO,8,3771,3778,2760
I.P.E.M. N° 78,COSTANERA LOS CIGARRALES B 750,3,COLON,40,UNQUILLO,14,3779,3792,4828
INST.PARROQ.NTA.SRA DE LOURDES,JUAN MILICH,3,COLON,40,UNQUILLO,10,3793,3802,3440
ESC.PIAS DE MENDIOLAZA,RUTA PROVINCIAL INTERMUNICIPAL E 57,3,COLON,40A,MENDIOLAZA,8,3803,3810,2744
ESC.PROV. D.F.SARMIENTO,MALVINAS ARGENTINAS Y SARMIENTO,3,COLON,40A,MENDIOLAZA,11,3811,3821,3773
I.P.E.M.N° 317,MENDIOLAZA,3,COLON,40A,MENDIOLAZA,10,3822,3831,3420
COLEGIO MARYLAND,GUEMES ESQ ALBERTI,3,COLON,41,VILLA ALLENDE,10,3832,3841,3450
ESC.PROV. J.DE SAN MARTIN,GOYCOECHEA 150,3,COLON,41,VILLA ALLENDE,13,3842,3854,4485
COLEGIO SAN JOSE,VILLA ALLENDE,3,COLON,41,VILLA ALLENDE,12,3855,3866,4140
INST GRAL S.MARTIN/17 DE AGOST,25 DE MAYO ESQ. TABLADA,3,COLON,41,VILLA ALLENDE,28,3867,3894,9655
INSTITUTO NTA.SRA. DE LUJAN,AV.SAN MARTIN 1.070,3,COLON,41,VILLA ALLENDE,10,3895,3904,3440
IPEM 130 RAUL DEL LLANO,DERQUI 635,3,COLON,41,VILLA ALLENDE,11,3905,3915,3784
JARDIN NOGAL HISTORICO,25 DE MAYO 109,3,COLON,41A,SALDAN,2,3916,3917,676
ESCUELA NOGAL HISTORICO,JOSE ACCASTELLI 252,3,COLON,41A,SALDAN,13,3918,3930,4382
ESC.DE COMERCIO J.M.PAZ,VELEZ SARSFIELD 647,3,COLON,41A,SALDAN,14,3931,3944,4718
ESCUELA DANDELION,9 DE JULIO 362,3,COLON,41A,SALDAN,3,3945,3947,1011
ESCUELA PROV.M. MORENO,PUBLICA S/N,4,CRUZ DEL EJE,42,BAÑADO DE SOTO,3,3948,3950,711
ESCUELA PROVINCIAL,CANDELARIA,4,CRUZ DEL EJE,43,CANDELARIA,1,3951,3951,51
ESC.PROV. CANTERAS IGUAZU,LAS CAÑADAS,4,CRUZ DEL EJE,43A,LAS CAÑADAS,1,3952,3952,193
ESC PROV JUAN B ALBERDI,PUBLICA S/N,4,CRUZ DEL EJE,43B,CRUZ DE CAÑA,2,3953,3954,227
IPEM N° 253,ALEM ESQ DOMINGO MATEU,4,CRUZ DEL EJE,44,CRUZ DEL EJE,17,3955,3971,5831
ESC.PROV.D.F.SARMIENTO,IRIGOYEN 247,4,CRUZ DEL EJE,44,CRUZ DEL EJE,13,3972,3984,4459
ESC.E. BAVIO,PELLEGRINI 180,4,CRUZ DEL EJE,44,CRUZ DEL EJE,13,3985,3997,4459
ESCUELA NORMAL,SARMIENTO 1155,4,CRUZ DEL EJE,44,CRUZ DEL EJE,17,3998,4014,5821
IPEM 273 M. BELGRANO,PELLEGRINI 445,4,CRUZ DEL EJE,44,CRUZ DEL EJE,13,4015,4027,4446
ESC.PROV.PCIA.DE LA RIOJA,RUTA 75,4,CRUZ DEL EJE,44A,LAS PLAYAS,2,4028,4029,618
ESC PROV MANUEL BELGRANO,PUBLICA S/N,4,CRUZ DEL EJE,45,EL BRETE,4,4030,4033,1172
ESC PROV GRAL SAN MARTIN,PUBLICA S/N,4,CRUZ DEL EJE,46,GUANACO MUERTO,3,4034,4036,958
ESCUELA PROVINCIAL,ALTO DE LOS QUEBRACH,4,CRUZ DEL EJE,46B,ALTO DE LOS QUEBRACHOS,2,4037,4038,430
ESC PROV JOSE MARIA PAZ,PUBLICA S/N,4,CRUZ DEL EJE,47,IGLESIA VIEJA,1,4039,4039,71
ESC PROV GRAL SAN MARTIN,RUTA PROVINCIAL N°15 S/N,4,CRUZ DEL EJE,48,LA HIGUERA,2,4040,4041,579
ESC.PROV.M.MORENO,LOS SAUCES,4,CRUZ DEL EJE,49,LOS SAUCES,1,4042,4042,82
ESCUELA M. GUEMES,MEDIA NARANJA,4,CRUZ DEL EJE,50,MEDIA NARANJA,3,4043,4045,862
ESC DOMINGO F SARMIENTO,PUBLICA S/N,4,CRUZ DEL EJE,50A,LOS CHAÑARITOS,3,4046,4048,769
I.P.E.A. N° 306 DR A SABATTINI -,,4,CRUZ DEL EJE,51,PASO VIEJO,3,4049,4051,978
ESC.PROV.J.M.PAZ,SANTA ANA,4,CRUZ DEL EJE,51A,SANTA ANA,1,4052,4052,86
ESC.PROV.J.V.GONZALEZ,PUBLICA,4,CRUZ DEL EJE,52,PICHANAS,1,4053,4053,159
ESC.PROV. BME. MITRE,PUBLICA,4,CRUZ DEL EJE,53,SAN ANTONIO,1,4054,4054,31
ESC. R.S. DE CALDELARI,LOS LEONES,4,CRUZ DEL EJE,53A,LOS LEONES,1,4055,4055,56
ESCUELA N°395(MANUEL LUCERO),EL ABRA,4,CRUZ DEL EJE,53B,EL ABRA,1,4056,4056,45
ESC PROV PTE ROQUE SAENZ PEÑA,LIBERTAD 1.043,4,CRUZ DEL EJE,54,SAN MARCOS SIERRAS,7,4057,4063,2333
ESC.PROV.M. BELGRANO,CANTERAS QUILPO,4,CRUZ DEL EJE,54A,CANTERAS QUILPO,1,4064,4064,95
ESC.PROV.B.RIVADAVIA,AVDA. MALVINAS ARGENTINAS,4,CRUZ DEL EJE,55,SERREZUELA,8,4065,4072,2662
ESC.PROV.DEAN G.FUNES,LA BATEA,4,CRUZ DEL EJE,55A,LA BATEA,1,4073,4073,169
ESC.PADRE B.DE LAS CASAS,JOSE IGNACIO PERALTA 249,4,CRUZ DEL EJE,56,SOTO,8,4074,4081,2728
INSTITUTO SANTO DOMINGO,SOTO,4,CRUZ DEL EJE,56,SOTO,4,4082,4085,1364
E.N.E.T. N°1,JUAN BAUTISTA ALBERDI 2.200,4,CRUZ DEL EJE,56,SOTO,5,4086,4090,1700
ESC NICOLAS AVELLANEDA,DEAN FUNES ESQ CORRIENTES,4,CRUZ DEL EJE,56,SOTO,4,4091,4094,1360
ESC.PROV.J.J.CASTELLI,PUBLICA,4,CRUZ DEL EJE,57,TUCLAME,4,4095,4098,1219
ESC.PROV. J.J. PASO,MARIANO MORENO,5,GENERAL ROCA,58,BRUZONE,1,4099,4099,240
ESC PROV JOSE MARIA PAZ,AV MANNY S/N,5,GENERAL ROCA,59,BUCHARDO,6,4100,4105,1803
ESCUELA J.M.PAZ,JOSE MARIA PAZ   ENRIQUE COOK 444,5,GENERAL ROCA,60,DEL CAMPILLO,7,4106,4112,2251
I.P.E.M. N° 219,DEL CAMPILLO,5,GENERAL ROCA,60,DEL CAMPILLO,3,4113,4115,963
ESC.PROV. D.F. SARMIENTO,PTE. JUAN D.PERON  VILLA TORROBA 75,5,GENERAL ROCA,61,HUINCA RENANCO,10,4116,4125,3310
ESC.PASO DE LOS ANDES,GARAY VILLA PACIFICO 121,5,GENERAL ROCA,61,HUINCA RENANCO,5,4126,4130,1650
COLEGIO NAC. L.V.MANSILLA,HUINCA RENANCO,5,GENERAL ROCA,61,HUINCA RENANCO,8,4131,4138,2640
ESC DR BENJAMIN DUPONT,LAVALLE S/N,5,GENERAL ROCA,62,ITALO,4,4139,4142,1091
ESC.PROV.D.F. SARMIENTO,JOVITA,5,GENERAL ROCA,63,JOVITA,7,4143,4149,2307
I.P.E.M. N° 221,JOVITA,5,GENERAL ROCA,63,JOVITA,6,4150,4155,1974
ESC PROV MANUEL BELGRANO,PUBLICA S/N,5,GENERAL ROCA,65,LECUEDER,1,4156,4156,18
ESC.PROV. SAN LUIS,TUCUMAN 225,5,GENERAL ROCA,66,MATTALDI,5,4157,4161,1633
ESC.PROV. V. MERCANTE,PUBLICA,5,GENERAL ROCA,67,ONAGOITY,1,4162,4162,67
ESC. ING.A.EBELOT,FELIPA ROSALES,5,GENERAL ROCA,68,PINCEN,1,4163,4163,254
ESC.PROV.F.N.LAPRIDA,PUBLICA,5,GENERAL ROCA,69,RANQUELES,1,4164,4164,51
INST. DE LOS SAGRADOS CORAZONE,SANTA MARI JOSEFA ROSSELLO 250,5,GENERAL ROCA,70,VILLA HUIDOBRO,8,4165,4172,2652
ESC.PROV.M.BELGRANO,PASCO 327,5,GENERAL ROCA,70,VILLA HUIDOBRO,7,4173,4179,2317
ESC.PROV. D.F.SARMIENTO,PUBLICA,5,GENERAL ROCA,71,VILLA SARMIENTO,1,4180,4180,308
ESC.PROV.J.CROTTO,VILLA VALERIA,5,GENERAL ROCA,72,VILLA VALERIA,8,4181,4188,2687
ESC.PROV. A.ARGENTINA,CORDOBA 301,6,GRAL SAN MARTIN,73,ARROYO ALGODON,5,4189,4193,1492
INST. SEC. COM. SAN JOSE,ARROYO CABRAL,6,GRAL SAN MARTIN,74,ARROYO CABRAL,5,4194,4198,1606
ESC.PROV.D.V.SARSFIELD,RIVADAVIA 410,6,GRAL SAN MARTIN,74,ARROYO CABRAL,4,4199,4202,1284
ESC.PROV.GRAL SAN MARTIN,25 DE MAYO 551,6,GRAL SAN MARTIN,75,AUSONIA,3,4203,4205,946
ESC PROV M R DE LA TORRE,DIESCISEIS 582,6,GRAL SAN MARTIN,76,CHAZON,3,4206,4208,994
INSTITUTO SEC. GRAL PAZ,BV.SRMIENTO Y S.NICOLA 390,6,GRAL SAN MARTIN,77,ETRURIA,5,4209,4213,1646
ESC.PROV. 12 DE OCTUBRE,ETRURIA,6,GRAL SAN MARTIN,77,ETRURIA,6,4214,4219,1974
ESC ESTEBAN ECHEVERRIA,GENERAL PAZ 556,6,GRAL SAN MARTIN,78,LA LAGUNA,4,4220,4223,1355
ESC.PROV. 25 DE MAYO,LA PLAYOSA,6,GRAL SAN MARTIN,79,LA PLAYOSA,9,4224,4232,2848
ESC.PROV.J.V.GONZALEZ,9 DE JULIO 350,6,GRAL SAN MARTIN,80,LUCA,2,4233,4234,588
ESC.PROV. ISLAS MALVINAS,RUTA PROV N 158,6,GRAL SAN MARTIN,81,MOJARRAS,1,4235,4235,68
ESC PROV CMTE L PIEDRABUENA,FELIPE LORENZATTI 875,6,GRAL SAN MARTIN,82,PALESTINA,2,4236,4237,539
ESC.PROV.D.F.SARMIENTO,PASCO,6,GRAL SAN MARTIN,83,PASCO,4,4238,4241,1195
ESC PROV JOSE DE SAN MARTIN,PUBLICA S/N,6,GRAL SAN MARTIN,84,SANABRIA,1,4242,4242,40
ESC.PROV.M.GUEMES,ANTONIO CONRERO 24,6,GRAL SAN MARTIN,86,SILVIO PELLICO,2,4243,4244,630
ESC. A. CAPDEVILA,TICINO,6,GRAL SAN MARTIN,87,TICINO,6,4245,4250,1998
ESC.R.DE ESCALADA,TIO PUJIO,6,GRAL SAN MARTIN,88,TIO PUJIO,12,4251,4262,3121
ESCUELA J.MARMOL,NAC. UNIDAS 385,6,GRAL SAN MARTIN,89,VILLA MARIA,10,4263,4272,3450
ESC.DR. J.BIANCO,BELGRANO 302,6,GRAL SAN MARTIN,89,VILLA MARIA,12,4273,4284,4140
ESC.REP.DEL PARAGUAY,CHILE 565,6,GRAL SAN MARTIN,89,VILLA MARIA,10,4285,4294,3450
INSTITUTO DEL ROSARIO,BV.ALVEAR 68,6,GRAL SAN MARTIN,89,VILLA MARIA,31,4295,4325,10695
INST.LA SANTISIMA TRINIDAD,SARSFIELD 1.072,6,GRAL SAN MARTIN,89,VILLA MARIA,27,4326,4352,9315
ESC.N.AVELLANEDA,BS.AS.E INT.MACIEL,6,GRAL SAN MARTIN,89,VILLA MARIA,14,4353,4366,4830
ESC.N.V.MERCANTE,SOBRAL 378,6,GRAL SAN MARTIN,89,VILLA MARIA,30,4367,4396,10337
IPEM N°275 EX COLEGIO NACIONAL,S.DEL ESTERO 618,6,GRAL SAN MARTIN,89,VILLA MARIA,15,4397,4411,5160
ESC.COM.A.OCAMPO,CATAMARCA 650,6,GRAL SAN MARTIN,89,VILLA MARIA,12,4412,4423,4128
I.P.E.T. N° 2,J.MULLER 651,6,GRAL SAN MARTIN,89,VILLA MARIA,14,4424,4437,4816
ESC.J.INGENIEROS,SANTA FE 1.271,6,GRAL SAN MARTIN,89,VILLA MARIA,13,4438,4450,4472
CENMA N° 96,SANTA FE 643,6,GRAL SAN MARTIN,89,VILLA MARIA,8,4451,4458,2752
INSTITUTO SAN ANTONIO,RUCCI 141,6,GRAL SAN MARTIN,89,VILLA MARIA,10,4459,4468,3440
ESC.BME.MITRE,MITRE 1147,6,GRAL SAN MARTIN,90,VILLA NUEVA,8,4469,4476,2752
IPEM N° 322,LIMA Y RIVADAVIA,6,GRAL SAN MARTIN,90,VILLA NUEVA,10,4477,4486,3440
ESCUELA PABLO VI,VILLA NUEVA,6,GRAL SAN MARTIN,90,VILLA NUEVA,6,4487,4492,2064
INSTITUTO INMAC.CONCEPCION,CABANILLAS 400,6,GRAL SAN MARTIN,90,VILLA NUEVA,13,4493,4505,4472
ESC.M.BELGRANO,BELGRANO 662,6,GRAL SAN MARTIN,90,VILLA NUEVA,11,4506,4516,3773
ESC.REP.DE BOLIVIA,D.FUNES 1250,6,GRAL SAN MARTIN,90,VILLA NUEVA,3,4517,4519,1029
ESC.PROV.FRAY M. ESQUIU,PUBLICA S/N,7,ISCHILIN,91,AVELLANEDA,2,4520,4521,485
ESC.PROV.J.V.RECLA,CANTERAS,7,ISCHILIN,91A,CANTERAS,1,4522,4522,23
ESC LIB GRAL SAN MARTIN,PUBLICA S/N,7,ISCHILIN,91B,LOS POZOS,1,4523,4523,118
ESC.PROV.M.MARTINEZ DE SUAREZ,PUBLICA,7,ISCHILIN,91C,VILLA GUTIERREZ,1,4524,4524,279
ESC.PROV.H.VIEYTES,PUBLICA,7,ISCHILIN,92,CAÑADA DE RIO PINTO,2,4525,4526,398
ESC JUAN M DE PUEYRREDON,PUBLICA S/N,7,ISCHILIN,93,COPACABANA,2,4527,4528,347
ESC PROV GRAL M GUEMES,PUBLICA S/N,7,ISCHILIN,94,CHUÑA,2,4529,4530,593
ESC.PROV.GRAL SAN MARTIN,DEAN FUNES,7,ISCHILIN,95,DEAN FUNES,9,4531,4539,3060
ESC.M.J.G.DE BELGRANO,JERONIMO L DE CABRERA L ALGARROBOS 451,7,ISCHILIN,95,DEAN FUNES,10,4540,4549,3400
ESC.PEDRO N.ARIAS,CORDOBA 87,7,ISCHILIN,95,DEAN FUNES,11,4550,4560,3740
ESC.PROV. M.MORENO,DORREGO   OBRAS SANITARIAS 326,7,ISCHILIN,95,DEAN FUNES,10,4561,4570,3400
ESC.A.M.SOBRAL,SANTIAGO DEL ESTERO Y LAS HERAS,7,ISCHILIN,95,DEAN FUNES,9,4571,4579,3057
ESC.AMANDA SUAREZ CORDOBA,SANTA ROSA ESQ. AMADEO SABATTINI,7,ISCHILIN,95,DEAN FUNES,5,4580,4584,1695
ESC.PROV.GUIDO SPANO,PUBLICA,7,ISCHILIN,96A,OLIVARES SAN NICOLAS,2,4585,4586,571
ESCUELA FERNANDO FADER,PUBLICA S/N,7,ISCHILIN,97,ISCHILIN,1,4587,4587,76
ESCUELA FRAY GUILLERMO BUTLER,PUBLICA S/N,7,ISCHILIN,98,JAIME PETER,1,4588,4588,55
ESC.PROVINCIA DE BS.AIRES,MARIANO MORENO 220,7,ISCHILIN,99,QUILINO ESTACION,8,4589,4596,2585
ESC.PROV.M.BELGRANO,QUILINO ESTACION,7,ISCHILIN,99,QUILINO ESTACION,5,4597,4601,1615
ESC.PROV.D.V.SARSFIELD,VELEZ SARSFIELD,7,ISCHILIN,100,QUILINO VILLA,3,4602,4604,983
ESC PROV JOAQUIN V GONZALEZ,PUBLICA S/N,7,ISCHILIN,101,TOYOS,1,4605,4605,82
ESC.EL GRAN CAPITAN,SARMIENTO 25,8,JUAREZ CELMAN,102,ALEJANDRO,8,4606,4613,2688
ESC.MISIONEROS SALESIANOS,ALEJANDRO,8,JUAREZ CELMAN,102,ALEJANDRO,7,4614,4620,2352
ESC.PROV.D.F.SARMIENTO,PUBLICA S/N,8,JUAREZ CELMAN,103,ASSUNTA,1,4621,4621,74
ESC.SEÑOR DE LA BUENA MUERTE,BENGOLEA,8,JUAREZ CELMAN,105,BENGOLEA,3,4622,4624,971
INST. G.L.DE CABRERA,CABRERA,8,JUAREZ CELMAN,106,CABRERA,9,4625,4633,3015
ESC.PROV.J.M.PAZ,CABRERA,8,JUAREZ CELMAN,106,CABRERA,8,4634,4641,2672
ESC.FRAY PIO BENTIVOGLIO,MAIPU   BARRIO ARGENTINO 962,8,JUAREZ CELMAN,106,CABRERA,7,4642,4648,2338
ESC.PROV.E.F.OLMOS,20 DE SEPTIEMBRE 584,8,JUAREZ CELMAN,106,CABRERA,7,4649,4655,2338
ESC.TTE. 1°M.C.ASUA,CARNERILLO,8,JUAREZ CELMAN,107,CARNERILLO,6,4656,4661,1884
ESC TTE CNEL J DUATE ARDOY,SARMIENTO 182,8,JUAREZ CELMAN,108,CHARRAS,4,4662,4665,1041
INSTITUTO SEC. 25 DE MAYO,DEHEZA,8,JUAREZ CELMAN,109,DEHEZA,6,4666,4671,2040
ESC.PROV.GRAL SAN MARTIN,BV SAN MARTIN 251,8,JUAREZ CELMAN,109,DEHEZA,12,4672,4683,4079
INST.TEC.ADRIAN P. URQUIA,GENERAL DEHEZA,8,JUAREZ CELMAN,109,DEHEZA,10,4684,4693,3390
ESC CARLOS MARIA DE ALVEAR,PUBLICA S/N,8,JUAREZ CELMAN,110,EL RASTREADOR,1,4694,4694,60
ESC.PROV.M.BELGRANO,12 DE OCTUBRE,8,JUAREZ CELMAN,110A,PACHECO DE MELO,1,4695,4695,72
ESC PROV DOMINGO F SARMIENTO,CARLOS ALBERTO MAYOL S/N,8,JUAREZ CELMAN,111,HUANCHILLA,4,4696,4699,1212
INST.NTA.M.DE LAS MERCEDES,9 DE JULIO 271,8,JUAREZ CELMAN,112,LA CARLOTA,8,4700,4707,2744
ESC.NAC.DE COMERCIO,V.SARSFIELD 651,8,JUAREZ CELMAN,112,LA CARLOTA,12,4708,4719,4114
ESC.FORTIN HEROICO,ACOSTA 673,8,JUAREZ CELMAN,112,LA CARLOTA,12,4720,4731,4104
ESC DOMINGO F SARMIENTO,SRITA BERNARDINA BAIGORRI 229,8,JUAREZ CELMAN,113,LOS CISNES,2,4732,4733,673
ESCUELA PROV.FRENCH Y BERUTTI,25 DE MAYO 135,8,JUAREZ CELMAN,114,OLAETA,2,4734,4735,644
ESC.CAP. F.D.ZARCO,MANUEL DE LA LASTRA 623,8,JUAREZ CELMAN,116,REDUCCION,5,4736,4740,1425
ESC.PROV.MARTIN DE ALVA,PASO DEL DURAZNO,8,JUAREZ CELMAN,116A,PASO DEL DURAZNO,1,4741,4741,110
INSTITUTO DR.M. BELGRANO,SANTA EUFEMIA,8,JUAREZ CELMAN,117,SANTA EUFEMIA,7,4742,4748,2122
ESC.PROV.J.B.ALBERDI,UCACHA,8,JUAREZ CELMAN,118,UCACHA,8,4749,4756,2588
ESC.MARTIN GUERRICO,UCACHA,8,JUAREZ CELMAN,118,UCACHA,7,4757,4763,2261
INSTITUTO SEC. V.SARSFIELD,LEANDRO N ALEM,9,MARCOS JUAREZ,119,ALEJO LEDESMA,4,4764,4767,1244
ESCUELA N.AVELLANEDA,HIPOLITO YRIGOYEN,9,MARCOS JUAREZ,119,ALEJO LEDESMA,2,4768,4769,622
ESC.PROV.D.F.SARMIENTO,LEANDRO N ALEM,9,MARCOS JUAREZ,119,ALEJO LEDESMA,4,4770,4773,1240
ESC.R.ESCALADA DE SAN MARTIN,AV. ESPAÑA 799,9,MARCOS JUAREZ,120,ARIAS,10,4774,4783,3440
ESC.PROV.SGTO.CABRAL,INTENDENTE MELQUIOT 922,9,MARCOS JUAREZ,120,ARIAS,9,4784,4792,3093
ESC JOSE MARIA PAZ,SARMIENTO,9,MARCOS JUAREZ,121,BALDISSERA,6,4793,4798,1992
ESC PROV DOMINGO F SARMIENTO,PUBLICA S/N,9,MARCOS JUAREZ,122,BARGE,1,4799,4799,228
IPEM N°151 J URBIZU,BV JOSE M ALDAO 1.160,9,MARCOS JUAREZ,123,CAMILO ALDAO,7,4800,4806,2235
ESC JUAN BAUTISTA ALBERDI,SAN MARTIN,9,MARCOS JUAREZ,123,CAMILO ALDAO,6,4807,4812,1914
ESC.SEC.TOMAS THOMAS,CORDOBA 138,9,MARCOS JUAREZ,124,CAVANAGH,4,4813,4816,1056
INST. SUP. JOSE MANUEL ESTRADA,SANTA FE 665,9,MARCOS JUAREZ,125,CORRAL DE BUSTOS,9,4817,4825,2997
ESC R ESCALADA DE SAN MARTIN,CORRAL DE BUSTOS,9,MARCOS JUAREZ,125,CORRAL DE BUSTOS,7,4826,4832,2331
COLEGIO JUAN XXIII,CORRAL DE BUSTOS,9,MARCOS JUAREZ,125,CORRAL DE BUSTOS,6,4833,4838,1998
ESC NOR SUP MAESTROS ARGENTINO,CORRAL DE BUSTOS,9,MARCOS JUAREZ,125,CORRAL DE BUSTOS,5,4839,4843,1665
COLEGIO SANTA JUANA DE ARCO,CRUZ ALTA,9,MARCOS JUAREZ,126,CRUZ ALTA,7,4844,4850,2323
IPEM N° 276,CRUZ ALTA,9,MARCOS JUAREZ,126,CRUZ ALTA,7,4851,4857,2317
ESC LIB GRAL SAN MARTIN,RIVADAVIA 1252 B°RIVADAVIA,9,MARCOS JUAREZ,126,CRUZ ALTA,5,4858,4862,1655
ESC DALMACIO VELEZ SARSFIELD,AV CORDOBA 324,9,MARCOS JUAREZ,127,GUATIMOZIN,7,4863,4869,2147
INST JOSE MARIA PAZ,INRIVILLE,9,MARCOS JUAREZ,128,INRIVILLE,5,4870,4874,1585
ESC MARIANO MORENO,INRIVILLE,9,MARCOS JUAREZ,128,INRIVILLE,5,4875,4879,1585
ESC.PROV.J.J.URQUIZA,INRIVILLE,9,MARCOS JUAREZ,128,INRIVILLE,1,4880,4880,317
ESC.PROV.PAULA ALBARRACIN,AV 24 DE SEPTIEMBRE,9,MARCOS JUAREZ,128A,SALADILLO,1,4881,4881,136
INST SEC ISLA VERDE,LIBERTAD 446,9,MARCOS JUAREZ,129,ISLA VERDE,12,4882,4893,4118
ESC.PROV.GRAL SAN MARTIN,ISLAS MALVINAS,9,MARCOS JUAREZ,130,LA ITALIANA,2,4894,4895,639
ESC JOAQUIN V GONZALEZ,RAMON INFANTE 422,9,MARCOS JUAREZ,131,LEONES,9,4896,4904,3006
IPEM N°256-LIB GRAL SAN MARTIN,LEONES,9,MARCOS JUAREZ,131,LEONES,7,4905,4911,2332
ESC DE COMERCIO Y BACHILLERATO,LEONES,9,MARCOS JUAREZ,131,LEONES,12,4912,4923,3996
ESCUELA VICTORIA OCAMPO,VILLA ELISA,9,MARCOS JUAREZ,131A,VILLA ELISA,1,4924,4924,26
ESC GENERAL SAN MARTIN,LOS SURGENTES,9,MARCOS JUAREZ,132,LOS SURGENTES,8,4925,4932,2509
COLEGIO SAGRADO CORAZON,LARDIZABAL 545,9,MARCOS JUAREZ,133,MARCOS JUAREZ,13,4933,4945,4433
ESC NORMAL SUP DR M BELGRANO,R SAENZ PEÑA Y S DEL ESTERO,9,MARCOS JUAREZ,133,MARCOS JUAREZ,17,4946,4962,5796
ESC BERNARDINO RIVADAVIA,SAN MARTIN 694,9,MARCOS JUAREZ,133,MARCOS JUAREZ,11,4963,4973,3740
IPEM N°51 NICOLAS AVELLANEDA,MARCOS JUAREZ,9,MARCOS JUAREZ,133,MARCOS JUAREZ,12,4974,4985,4080
ESC MARIANO MORENO,SAN JUAN 1090 SUR,9,MARCOS JUAREZ,133,MARCOS JUAREZ,8,4986,4993,2720
ESCUELA BARTOLOME MITRE,HIPOLITO YRIGOYEN 1409 NOROESTE,9,MARCOS JUAREZ,133,MARCOS JUAREZ,7,4994,5000,2380
ESC JOSE MANUEL ESTRADA,MONTE BUEY,9,MARCOS JUAREZ,134,MONTE BUEY,8,5001,5008,2721
ESC MANUEL BELGRANO,MONTE BUEY,9,MARCOS JUAREZ,134,MONTE BUEY,6,5009,5014,2040
INST.SEC.GRAL J.M.PAZ,MONTE BUEY,9,MARCOS JUAREZ,134,MONTE BUEY,2,5015,5016,680
ESC.PROV.GRAL SAN MARTIN,AV ITALIA 448,9,MARCOS JUAREZ,135,CAP.B.O HIGGINS,1,5017,5017,320
ESC ROQUE SAENZ PEÑA,ROCA,9,MARCOS JUAREZ,136,ROCA,5,5018,5022,1618
ESC 9 DE JULIO,ALSINA 517 SUR,9,MARCOS JUAREZ,136,ROCA,3,5023,5025,969
INSTITUTO MANUEL BELGRANO,SAIRA,9,MARCOS JUAREZ,137,SAIRA,3,5026,5028,755
ESC PROV COMTE ROSENDO LEAL,CESAR MANUEL VERA S/N,10,MINAS,138,CIENAGA DEL CORO,3,5029,5031,926
ESC MIGUEL DE AZCUENAGA,RUMIACO,10,MINAS,138A,RUMIACO,1,5032,5032,27
ESC.PROV.FRAY M.ESQUIU,PUBLICA,10,MINAS,138B,RUMIHUASI,1,5033,5033,101
ESC PROV NIÑAS DE AYOHUMA,PUBLICA S/N,10,MINAS,138C,ESTANCIA DE GUADALUPE,2,5034,5035,429
ESC.PROV.MONS.R. LEAL,PUBLICA,10,MINAS,138D,TOSNO,1,5036,5036,186
LOCAL COMUNAL,,10,MINAS,139,GUASAPAMPA,1,5037,5037,290
ESC.PROV.R.VERA PEÑALOZA,AGUA DE RAMON,10,MINAS,139A,AGUA DE RAMON,1,5038,5038,89
ESC PROV GRAJ J DE SAN MARTIN,PUBLICA S/N,10,MINAS,139B,LA PLAYA,1,5039,5039,237
ESC PROV GREGORIA PEREZ,PUBLICA S/N,10,MINAS,140,LA ARGENTINA,1,5040,5040,216
ESC MARTIN MIGUEL DE GUEMES,OJO DE AGUA DE TOTOX,10,MINAS,140A,OJO DE AGUA DE TOTOX,1,5041,5041,89
ESC PRIMARIA JORGE LUIS BORGES,PIEDRITA BLANCA,10,MINAS,141,PIEDRITA BLANCA,1,5042,5042,61
ESC PROV ANGEL V PEÑALOZA,PUBLICA S/N,10,MINAS,141A,EL CHACHO,1,5043,5043,158
ESC.SEC.J.L.DE CABRERA,RIVADAVIA E IRIGOYEN,10,MINAS,142,SAN CARLOS,6,5044,5049,2028
ESC.PROV.J.J.CASTELLI.,PUBLICA,10,MINAS,142A,TALAINI,1,5050,5050,152
ESC PROV MARIANO MORENO,PUBLICA S/N,11,POCHO,144,CHANCANI,3,5051,5053,1010
ESC.PROV.L.LUGONES,PUBLICA,11,POCHO,144A,LAS JARILLAS,1,5054,5054,93
ESC R ESCALADA DE SAN MARTIN,EL MEDANITO,11,POCHO,144B,EL MEDANITO,1,5055,5055,64
ESC.PROV.D.FRENCH,PUBLICA,11,POCHO,145,POCHO,2,5056,5057,499
ESCUELA N°157,LAS PALMAS,11,POCHO,145A,LAS PALMAS,1,5058,5058,254
ESC GENERAL JOSE DE SAN MARTIN,AV CURA BROCHERO 150,11,POCHO,146,SALSACATE,6,5059,5064,1978
ESC.PROV.M.BELGRANO,TALA CAÑADA,11,POCHO,146A,TALA CAÑADA,1,5065,5065,283
ESC.PROV. E.ECHEVERRIA,SAN JERONIMO,11,POCHO,146B,SAN JERONIMO,1,5066,5066,290
ESC ROQUE SAENZ PEÑA,LOS TALARES,11,POCHO,146C,LOS TALARES,1,5067,5067,141
INST SERVILIANO DIAZ,SAN MARTIN 675,12,PUNILLA,147,BIALET MASSE,5,5068,5072,1635
INST NTA SRA DEL ROSARIO,BIALET MASSE,12,PUNILLA,147,BIALET MASSE,5,5073,5077,1635
ESC DR BIALET MASSE,ROQUE SAENZ PEÑA 91,12,PUNILLA,147,BIALET MASSE,7,5078,5084,2284
ESC HOGAR ALBERTO MAGGI,CEFERINO NAMUNCURA 62,12,PUNILLA,147A,SAN ROQUE,4,5085,5088,1103
ESC DR JERONIMO J DEL BARCO,VILLA PARQUE SIQUIMAN,12,PUNILLA,147B,VILLA PARQUE SIQUIMAN,6,5089,5094,1746
ESC GRAL JOSE DE SAN MARTIN,SARMIENTO 380,12,PUNILLA,148,CAPILLA DEL MONTE,8,5095,5102,2760
IPEM N° 279,HIPOLITO YRIGOYEN 450,12,PUNILLA,148,CAPILLA DEL MONTE,12,5103,5114,4140
ESC ESP JUAN MANUEL FERNANDEZ,AV PUEYRREDON 131,12,PUNILLA,148,CAPILLA DEL MONTE,10,5115,5124,3440
ESC GRAL JOSE DE SAN MARTIN,RUTA NACIONAL N°38,12,PUNILLA,149,CASA GRANDE,2,5125,5126,643
COLEGIO PARROQUIAL PIO XII,OBISPO BUSTOS 816,12,PUNILLA,150,COSQUIN,11,5127,5137,3742
IPEM N°60 M MORENO(EX IPET 13),PALEMON CARRANZA 1085,12,PUNILLA,150,COSQUIN,9,5138,5146,3060
IPEM N°157-PTE SARMIENTO,P CARRANZA 940,12,PUNILLA,150,COSQUIN,8,5147,5154,2720
ESC NORMAL SUP R SAENZ PEÑA,SAN MARTIN 394,12,PUNILLA,150,COSQUIN,8,5155,5162,2720
ESC TTE GRAL JULIO A ROCA,SAN MARTIN Y SARMIENTO S/N,12,PUNILLA,150,COSQUIN,13,5163,5175,4420
ESC ESP DR J REYES CONTRERAS,MONS DE ANDREA S/N B°SANTA TERESITA,12,PUNILLA,150,COSQUIN,7,5176,5182,2380
ESC P ALBARRACIN DE SARMIENTO,PUBLICA S/N,12,PUNILLA,151,CHARBONIER,2,5183,5184,658
ESC BERNARDINO RIVADAVIA,HUERTA GRANDE,12,PUNILLA,152,HUERTA GRANDE,8,5185,5192,2662
I.P.E.M N° 200,ARRABARRENA ESQ PROV UNIDAS S/N,12,PUNILLA,152,HUERTA GRANDE,9,5193,5201,2988
IPEM N° 339,LOS COCOS ESQ PEPERINA,12,PUNILLA,152A,VILLA GIARDINO,6,5202,5207,2000
ESC ESTEBAN ECHEVERRIA,CHILE S/N B°INDEPENDENCIA,12,PUNILLA,152A,VILLA GIARDINO,5,5208,5212,1665
COL JUANA MICONO DE GIARDIN,AV SAN MARTIN 762,12,PUNILLA,152A,VILLA GIARDINO,4,5213,5216,1332
ESC M E H DE GONZALEZ ELIZALDE,RIO NEGRO S/N B°ARGENTINO,12,PUNILLA,153,LA CUMBRE,6,5217,5222,2014
INSTITUTO GRAL SAN MARTIN,9 DE JULIO 564 B°GOLF,12,PUNILLA,153,LA CUMBRE,8,5223,5230,2680
ESC JOSEFA MARIA BUSTOS,ALBERDI 277,12,PUNILLA,153,LA CUMBRE,7,5231,5237,2345
ESC JOSE MARIA PAZ,HIPOLITO YRIGOYEN 431 B°SAN JORGE,12,PUNILLA,154,LA FALDA,7,5238,5244,2366
IPEM N°142 JOAQUIN V GONZALEZ,SAN GERONIMO Y LAS AMERICAS S/N,12,PUNILLA,154,LA FALDA,11,5245,5255,3718
ESC MATEO J MOLINA,AV EDEN 445,12,PUNILLA,154,LA FALDA,10,5256,5265,3380
ESC NICOLAS AVELLANEDA,PROGRESO 399 B°SANTA ROSA,12,PUNILLA,154,LA FALDA,7,5266,5272,2362
ESC AERONAUTICA ARGENTINA,OCAMPO Y ROMAN DEHEZA S/N-LA LOMITA,12,PUNILLA,154,LA FALDA,6,5273,5278,2022
ESC INES MOYANO DE MOLINA,SAN ESTEBAN,12,PUNILLA,155,SAN ESTEBAN,3,5279,5281,753
ESC DRA CECILIA GRIERSON,LOS COCOS,12,PUNILLA,155A,LOS COCOS,3,5282,5284,1022
ESC CARLOS NICANDRO PAZ,SAN MARTIN 255,12,PUNILLA,156,VILLA CARLOS PAZ,17,5285,5301,5865
ESC PRESIDENTE SARMIENTO,LOS GIGANTES S/N-B°M MUÑOZ,12,PUNILLA,156,VILLA CARLOS PAZ,12,5302,5313,4140
ESC ISLA DE LOS ESTADOS,LOS CEIBOS S/N B°LA QUINTA,12,PUNILLA,156,VILLA CARLOS PAZ,10,5314,5323,3450
INST ALFONSINA STORNI(EX IESS),SOLIS 283 B° VILLA DOMINGUEZ,12,PUNILLA,156,VILLA CARLOS PAZ,21,5324,5344,7245
INST BERNARDO D'ELIA,ASUNCION B°LA QUINTA 440,12,PUNILLA,156,VILLA CARLOS PAZ,15,5345,5359,5168
INST R ESCALADA DE SAN MARTIN,ESTRADA Y ANTARTIDA,12,PUNILLA,156,VILLA CARLOS PAZ,16,5360,5375,5504
INST INDUSTRIAL CRISTO OBRERO,FLORENCIO SANCHEZ S/N-B°LAS MALVINAS,12,PUNILLA,156,VILLA CARLOS PAZ,10,5376,5385,3440
PRIMARIO JOSE DE SAN MARTIN,AMEGHINO Y BALCARCE,12,PUNILLA,156,VILLA CARLOS PAZ,8,5386,5393,2752
IPEM N° 365-DR RENE FAVALORO,GOBERNADOR ALVAREZ 131,12,PUNILLA,156,VILLA CARLOS PAZ,10,5394,5403,3440
INST BILINGUE DANTE ALIGHIERI,ALFONSINA STORNI Y LOS ALERCES,12,PUNILLA,156,VILLA CARLOS PAZ,17,5404,5420,5848
ESC RICARDO BERNABE FERNANDEZ,LAS MARGARITAS 255-VA INDEPENDENCIA,12,PUNILLA,156,VILLA CARLOS PAZ,8,5421,5428,2752
ESC JOSE A ALVAREZ CONDARCO,IGUALDAD 199 B°SAN IGNACIO,12,PUNILLA,156,VILLA CARLOS PAZ,6,5429,5434,2064
COLEGIO COSTA AZUL,HUARPES Y COMECHINGONES-B°COSTA AZUL,12,PUNILLA,156,VILLA CARLOS PAZ,9,5435,5443,3096
ESC MERCEDES S M DE BALCARCE,GENERAL SAN MARTIN S/N,12,PUNILLA,156A,YCHO CRUZ,5,5444,5448,1620
LOCAL COMUNAL,CUESTA BLANCA,12,PUNILLA,156B,CUESTA BLANCA,2,5449,5450,425
EDIFICIO COMUNAL,MAYU SUMAJ,12,PUNILLA,156C,MAYU SUMAJ,4,5451,5454,1115
ESC JUAN JOSE PASO,RUTA PROV. 14-KM.43 CENTRO,12,PUNILLA,156D,SAN ANTONIO DE ARREDONDO,6,5455,5460,2066
IPEM 348,RUTA 14 Y CNO A LAS JARILLAS,12,PUNILLA,156D,SAN ANTONIO DE ARREDONDO,7,5461,5467,2408
EDIFICIO COMUNAL,TALA HUASI,12,PUNILLA,156E,TALA HUASI,1,5468,5468,235
COLEGIO SAN ROQUE,LAVALLE 2730 VILLA BUSTOS,12,PUNILLA,157,SANTA MARIA,6,5469,5474,2028
ESC BENJAMIN MATIENZO,DR.MIGUEL A. VOCOS S/N TILLARD,12,PUNILLA,157,SANTA MARIA,4,5475,5478,1349
ESC JUAN BAUTISTA AZOPARDO,SARMIENTO 59 VILLA BUSTOS,12,PUNILLA,157,SANTA MARIA,7,5479,5485,2359
INST. SEC. ORIENTACION REGIONA,VILLA BUSTOS,12,PUNILLA,157,SANTA MARIA,7,5486,5492,2359
ESC DOMINGO FAUSTINO SARMIENTO,MARIANO MORENO 597 B°VILLA NUEVA,12,PUNILLA,158,TANTI,9,5493,5501,2966
IPEM N°84 J VOCOS LESCANO,SAN FRANCISCO 33 LA ESTANCIA,12,PUNILLA,158,TANTI,9,5502,5510,2961
ESC.PROV.D. FRENCH,CALLE 10,12,PUNILLA,158A,CABALANGO,2,5511,5512,440
LOCAL COMUNAL,ESTANCIA VIEJA,12,PUNILLA,158B,ESTANCIA VIEJA,4,5513,5516,1038
IPEM N° 332,LOS TALAS ESQ. LAS ROSAS,12,PUNILLA,158C,VILLA SANTA CRUZ DEL LAGO,8,5517,5524,2540
IPEM N° 335,GOBERNADOR NUÑEZ 73,12,PUNILLA,159,VALLE HERMOSO,8,5525,5532,2712
INST.NTA.SRA. DEL CALVARIO,SAN MARTIN 12,12,PUNILLA,159,VALLE HERMOSO,8,5533,5540,2704
ESC DOMINGO FAUSTINO SARMIENTO,ACHIRAS,13,RIO CUARTO,160,ACHIRAS,8,5541,5548,2611
ESC PROV DOMINGO F SARMIENTO,PUBLICA S/N,13,RIO CUARTO,160A,LA CAROLINA,1,5549,5549,243
INSTITUTO ADELIA MARIA,AV SAN MARTIN 1050 CENTRO,13,RIO CUARTO,161,ADELIA MARIA,11,5550,5560,3674
ESC GENERAL SAN MARTIN,SARMIENTO 98 CENTRO,13,RIO CUARTO,161,ADELIA MARIA,8,5561,5568,2667
ESC JOSE MARIA PAZ,GRAL ROCA 643 CENTRO,13,RIO CUARTO,162,ALCIRA,7,5569,5575,2412
ESC PERITO FRANCISCO MORENO,DEAN FUNES Y HEROES ANONIMOS S/N,13,RIO CUARTO,162,ALCIRA,9,5576,5584,3096
IPEM N° 119 NESTOR ZARAZAGA,PUBLICA S/N,13,RIO CUARTO,163,ALPA CORRAL,4,5585,5588,1215
ESC PROV BERNARDINO RIVADAVIA,VELEZ SARSFIELD 50,13,RIO CUARTO,164,BAIGORRIA,6,5589,5594,1757
ANGELES CUSTODIOS/SAGRADA FLIA,ISABEL LA CATOLICA Y E JENNER S/N,13,RIO CUARTO,165,BANDA NORTE,12,5595,5606,4104
ESC DR ADOLFO ALSINA,AVENIDA GARIBALDI 740,13,RIO CUARTO,165,BANDA NORTE,11,5607,5617,3761
MERC DEL NIÑO JESUS/S FCO ASIS,VICTOR HUGO 885,13,RIO CUARTO,165,BANDA NORTE,18,5618,5635,6138
INST SUP RAMON MENENDEZ PIDAL,AV JOSE GARIBALDI 50,13,RIO CUARTO,165,BANDA NORTE,12,5636,5647,4092
ESC PROVINCIA SANTA CRUZ,SANTA FE ESQ URUGUAY S/N,13,RIO CUARTO,165,BANDA NORTE,13,5648,5660,4433
ESC REPUBLICA DEL URUGUAY,SAN LUIS 342,13,RIO CUARTO,165,BANDA NORTE,6,5661,5666,2046
IPEM N°95 M SANCHEZ DE THOMPSO,MANCO CAPAC 50,13,RIO CUARTO,165,BANDA NORTE,14,5667,5680,4774
CNMA 24-ANEXO PCIA STA CRUZ,EL SALVADOR 840 B° BALACCO,13,RIO CUARTO,165,BANDA NORTE,2,5681,5682,682
ESC VICTOR MERCANTE,FRAY MAMERTO ESQUIU 25,13,RIO CUARTO,166,BERROTARAN,8,5683,5690,2673
INSTITUTO PARROQ.BERROTARAN,AQUINO ARGUELLO ARDILES 203,13,RIO CUARTO,166,BERROTARAN,11,5691,5701,3674
ESC.FRAY M.ALVAREZ,SARMIENTO 187,13,RIO CUARTO,167,BULNES,4,5702,5705,1083
ESC PROV GRAL J DE SAN MARTIN,BV CORDOBA S/N,13,RIO CUARTO,168,CHAJAN,3,5706,5708,827
ESC SUBTTE RODOLFO H BERDINA,AV SAN MARTIN S/N,13,RIO CUARTO,169,CHUCUL,2,5709,5710,413
INST SEC LA ASUNCION DE MARIA,PASAJE CURA BROCHERO 189,13,RIO CUARTO,170,ELENA,5,5711,5715,1593
ESC RICARDO GUTIERREZ,ELENA,13,RIO CUARTO,170,ELENA,4,5716,5719,1272
ESC PROV JOSE DE SAN MARTIN,RUTA NACIONAL 36 KM 614 S/N,13,RIO CUARTO,171,ESPINILLO,1,5720,5720,153
ESC.PROV.C.SAAVEDRA,HOLMBERG,13,RIO CUARTO,172,HOLMBERG,6,5721,5726,2019
ESC.S.R.DE ZAVALIA,HOLMBERG,13,RIO CUARTO,172,HOLMBERG,5,5727,5731,1680
IPEM N° 125 R SCALABRINI ORTIZ,,13,RIO CUARTO,172,HOLMBERG,3,5732,5734,1008
ESC JOSE DE SAN MARTIN,CALLE PUBLICA,13,RIO CUARTO,173,LA ARGENTINA,1,5735,5735,17
ESC PROV JOSE DE SAN MARTIN,SAN MARTIN S/N,13,RIO CUARTO,174,LA CAUTIVA,3,5736,5738,736
ESC PROV JOSE DE SAN MARTIN,PUBLICA S/N,13,RIO CUARTO,175,LA GILDA,1,5739,5739,73
ESC R ESCALADA DE SAN MARTIN,LA INVERNDA,13,RIO CUARTO,176,LA INVERNADA,1,5740,5740,71
ESC LEONILA DE LAS M LEMOS,MAIPU 535 NORTE,13,RIO CUARTO,177,LAS ACEQUIAS,8,5741,5748,2569
ESC.PROV.J.DE SAN MARTIN,LAS CAÑITAS,13,RIO CUARTO,178,LAS CAÑITAS,1,5749,5749,49
ESC.C.G. DE REZZANO,CALLE 11,13,RIO CUARTO,178A,LAS ALBAHACAS,2,5750,5751,440
ESC.ALBERGUE J.HERNANDEZ,PUBLICA,13,RIO CUARTO,178B,VILLA EL CHACAY,1,5752,5752,126
ESC JORGE ALEHANDRO NEWBERY,ESPAÑA 36,13,RIO CUARTO,179,LAS HIGUERAS,14,5753,5766,4830
JARD INF JORGE A NEWBERY,ESPAÑA 86 B° SAN MARTIN,13,RIO CUARTO,179,LAS HIGUERAS,4,5767,5770,1379
ESC.PROV.J.M.PAZ,AVDA. 22 DE OCTUBRE,13,RIO CUARTO,180,LAS PEÑAS,1,5771,5771,215
ESC ANTONIO SOBRAL,PUBLICA S/N,13,RIO CUARTO,181,LOS CUATRO VIENTOS,1,5772,5772,168
ESC CAP DE FRAGATA MOYANO,JULIANA GARCIA PUBLILL 560,13,RIO CUARTO,182,LAS VERTIENTES,3,5773,5775,908
INST JUAN PASCUAL PRINGLES,AV CARLOS S YDE 684,13,RIO CUARTO,183,VICUÑA MACKENNA,10,5776,5785,3390
ESC GUIDO SPANO,SARMIENTO 672 CENTRO,13,RIO CUARTO,183,VICUÑA MACKENNA,8,5786,5793,2709
ESC GRAL NAPOLEON URIBURU,LIB GENERAL SAN MARTIN 318 CENTRO,13,RIO CUARTO,183,VICUÑA MACKENNA,9,5794,5802,3042
ESC FRAY MARCOS DONATTI,MOLDES,13,RIO CUARTO,184,MOLDES,9,5803,5811,3050
IPEM N°94 DOLORES L DE LAVALLE,MOLDES,13,RIO CUARTO,184,MOLDES,8,5812,5819,2704
ESC NICOLAS AVELLANEDA,MOLDES,13,RIO CUARTO,184,MOLDES,7,5820,5826,2366
ESC.PROV.M.BELGRANO,SARMIENTO,13,RIO CUARTO,184A,MONTE DE LOS GAUCHOS,2,5827,5828,686
ESC NICOLAS AVELLANEDA,VICENTE LOPEZ 538,13,RIO CUARTO,186,PUEBLO ALBERDI,12,5829,5841,4104
IPEMN° 26 JUAN FILLOY,BELISARIO ROLDAN 535,13,RIO CUARTO,186,PUEBLO ALBERDI,10,5842,5851,3420
COLEGIO MARIA BENITA ARIAS,MONTEVIDEO 751,13,RIO CUARTO,186,PUEBLO ALBERDI,10,5852,5861,3420
ESC GRAL JUSTO S ANAYA,AZOPARDO 1270 FENIX,13,RIO CUARTO,186,PUEBLO ALBERDI,14,5862,5875,4788
INST LANTERIANO LA MERCED,BELISARIO ROLDAN 275,13,RIO CUARTO,186,PUEBLO ALBERDI,18,5876,5893,6156
ESC ARZOBISPO ANTONIO ESPINOSA,OLEGARIO ANDRADE 1020,13,RIO CUARTO,186,PUEBLO ALBERDI,11,5894,5904,3761
ESC CAP DE NAV S ALBARRACIN,PUEYRREDON,13,RIO CUARTO,187,PUEYRREDON,1,5905,5905,103
ESC.NORM.NAC.MIXTA,CONSTITUCION 1040,13,RIO CUARTO,188,RIO CUARTO,24,5906,5929,8280
INST SAN BUENAVENTURA,SAN MARTIN 250,13,RIO CUARTO,188,RIO CUARTO,12,5930,5941,4140
ESC FLORENTINO AMEGHINO,9 DE JULIO 314,13,RIO CUARTO,188,RIO CUARTO,10,5942,5951,3450
DICHIARA-EX ESC.GRAL S.MARTIN,BOLIVAR Y ALBERDI,13,RIO CUARTO,188,RIO CUARTO,9,5952,5960,3105
ESCUELA GENERAL PAZ,MITRE 850,13,RIO CUARTO,188,RIO CUARTO,13,5961,5973,4485
COL NTRA SRA DEL CARMEN,BAIGORRIA 373,13,RIO CUARTO,188,RIO CUARTO,17,5974,5990,5865
ESC ALTE BROWN,RIO QUINTO 660,13,RIO CUARTO,188,RIO CUARTO,8,5991,5998,2760
ESCUELA GRAL ROCA,PASO 790 B° SANTA ROSA,13,RIO CUARTO,188,RIO CUARTO,12,5999,6010,4140
ESC BARTOLOME MITRE,LAVALLE 1452,13,RIO CUARTO,188,RIO CUARTO,12,6011,6022,4134
ESC 21 DE JULIO,BAIGORRIA 552,13,RIO CUARTO,188,RIO CUARTO,10,6023,6032,3440
ESC MANUEL BELGRANO,SOBREMONTE 1333,13,RIO CUARTO,188,RIO CUARTO,14,6033,6046,4816
E.N.E.T. N° 1,BAIGORRIA 527,13,RIO CUARTO,188,RIO CUARTO,12,6047,6058,4128
ESC.NORMAL COMERCIAL,BAIGORRIA 463,13,RIO CUARTO,188,RIO CUARTO,27,6059,6085,9288
ESC VELEZ SARSFIELD,MENDOZA 1502,13,RIO CUARTO,188,RIO CUARTO,10,6086,6095,3440
ESCUELA PIAS,BV GRAL ROCA 701,13,RIO CUARTO,188,RIO CUARTO,8,6096,6103,2752
COLEGIO GALILEO GALILEI,ALVEAR 1040,13,RIO CUARTO,188,RIO CUARTO,12,6104,6115,4128
COLEGIO HISPANO ARGENTINO,FOTHERINGHAM 68,13,RIO CUARTO,188,RIO CUARTO,14,6116,6129,4816
INSTITUTO LA CONSOLATA,HIPOLITO IRIGOYEN 482,13,RIO CUARTO,189,SAMPACHO,7,6130,6136,2373
ESC SAN MARTIN,SAMPACHO,13,RIO CUARTO,189,SAMPACHO,7,6137,6143,2366
INSTPABLO ANTONIO PIZZURNO,SAMPACHO,13,RIO CUARTO,189,SAMPACHO,8,6144,6151,2704
ESC.SAN JUAN BOSCO,PUBLICA,13,RIO CUARTO,190,SAN AMBROSIO,1,6152,6152,128
INST JUAN BAUTISTA ALBERDI,BV LORENZO BERARDO 325 NORTE,13,RIO CUARTO,191,SAN BASILIO,4,6153,6156,1308
ESC JOSE DE SAN MARTIN,BELGRANO 121 B°CENTRO,13,RIO CUARTO,191,SAN BASILIO,6,6157,6162,1958
ESC.PROV.R.E.DE SAN MARTIN,REMEDIOS ESCALADA DE SAN MARTIN,13,RIO CUARTO,191A,MALENA,1,6163,6163,308
ESC R ESCALADA DE SAN MARTIN,SUCO,13,RIO CUARTO,192,SUCO,2,6164,6165,477
ESC.PROV.J.M.ESTRADA,AVELLANEDA 181,13,RIO CUARTO,193,TOSQUITA,2,6166,6167,526
ESCUELA N°359,WASHINGTON,13,RIO CUARTO,194,WASHINGTON,3,6168,6169,556
ESC.PROV.J.DE SAN MARTIN,PUBLICA S/N,14,RIO PRIMERO,195,ATAHONA,1,6170,6170,166
ESC.PROV.M.MORENO,CALLE 12,14,RIO PRIMERO,196,CAÑADA DE MACHADO,1,6171,6171,229
ESC PROV JOAQUIN V GONZALEZ,JOAQUIN V GONZALEZ S/N,14,RIO PRIMERO,197,LA POSTA,1,6172,6172,337
ESC PROV MARTIN GUEMES,MARTIN GUEMES S/N,14,RIO PRIMERO,198,CAPILLA DE REMEDIOS,4,6173,6176,1065
ESCUELA N°315,CHALACEA,14,RIO PRIMERO,199,CHALACEA,1,6177,6177,230
ESC M.C.CALDECOT DE ARGUELLO,FIGUEROA ALCORTA S/N,14,RIO PRIMERO,200,DIEGO DE ROJAS,2,6178,6179,503
ESC JOSE MARIA PAZ,LAS CUATRO ESQUINAS,14,RIO PRIMERO,201,COLONIA LAS CUATRO ESQUINAS,1,6180,6180,114
ESC MAEST F BELLORA DE DAVILA,LAS GRAMILLAS,14,RIO PRIMERO,201A,LAS GRAMILLAS,1,6181,6181,137
ESC PROV JOSE MANUEL ESTRADA,MALVINAS ARGENTINAS S/N,14,RIO PRIMERO,202,ESQUINA,1,6182,6182,341
ESC.R.E.DE SAN MARTIN,KM. 658,14,RIO PRIMERO,203,PEDRO E.VIVAS,2,6183,6184,352
INST MONSEÑOR ESQUIU,MARIANO MORENO 749 CENTRO,14,RIO PRIMERO,204,LA PARA,6,6185,6190,2004
ESC MARIANO FRAGUEIRO,MARIANO FRAGUEIRO 385,14,RIO PRIMERO,204,LA PARA,5,6191,6195,1665
ESC PROV FRAY MAMERTO ESQUIU,SAN LORENZO 698,14,RIO PRIMERO,205,LA PUERTA,6,6196,6201,2012
ESCUELA N°411,LA CAÑADA,14,RIO PRIMERO,206,LAS HERAS,1,6202,6202,61
ESC DALMIRA MURO(EX DEL CHACO),LAS SALADAS,14,RIO PRIMERO,207,LAS SALADAS,1,6203,6203,257
ESCUELA N°111,COMECHINGONES,14,RIO PRIMERO,208,COMECHINGONES,1,6204,6204,311
ESC.PROV.J.M.PAZ,PUBLICA,14,RIO PRIMERO,209,MAQUINISTA GALLINI,1,6205,6205,182
ESC DOMINGO F SARMIENTO,PUBLICA S/N(HOY:BLAS DE ROSALES),14,RIO PRIMERO,210,BLAS DE ROSALES,1,6206,6206,106
MARGARITA V LUDUEÑA DE LAZO,SARMIENTO   LAS MALVINAS 571,14,RIO PRIMERO,211,MONTE CRISTO,8,6207,6214,2701
INST PQUIAL MONTE CRISTO,ROQUE SAENZ PEÑA 380,14,RIO PRIMERO,211,MONTE CRISTO,12,6215,6226,4044
ESCUELA MAESTRO DOMINGO NOGAL,AV SAN MARTIN,14,RIO PRIMERO,211,MONTE CRISTO,8,6227,6234,2696
ESC.PROV.J.M.PAZ,PUBLICA,14,RIO PRIMERO,212,MONTE DEL ROSARIO,1,6235,6235,146
ESC PROV DOMINGO F SARMIENTO,PUBLICA S/N,14,RIO PRIMERO,212B,EL CRISPIN,1,6236,6236,253
ESCUELA R.GUTIERREZ,GENERAL PAZ 788,14,RIO PRIMERO,213,OBISPO TREJO,7,6237,6243,2407
ESC.PROV.D.F.SARMIENTO,AVDA.SARMIENTO E 74,14,RIO PRIMERO,214,PIQUILLIN,5,6244,6248,1676
ESC.PROV.M.BELGRANO,CHACON DE CUESTAS,14,RIO PRIMERO,215,PLAZA DE MERCEDES,1,6249,6249,140
ESC PROV JUAN JOSE PASO,PUBLICA S/N,14,RIO PRIMERO,215A,LA QUINTA,1,6250,6250,255
ESC.PROV.GRAL SAN MARTIN,PUBLICA,14,RIO PRIMERO,216,PUNTA DEL AGUA,1,6251,6251,38
ESC.PROV.1ER.GOBIERNO PATRIO,QUEBRACHO,14,RIO PRIMERO,217,QUEBRACHO,1,6252,6252,93
EX-ESCUELA N°279,PABLO ROBERT 182,14,RIO PRIMERO,218,RIO PRIMERO,8,6253,6260,2660
ESC GRAL JOSE DE SAN MARTIN,CORRIENTES   LUCHI 251,14,RIO PRIMERO,218,RIO PRIMERO,8,6261,6268,2656
IPEM N° 164 ATALIVA HERRERA,AV CONTARDO FERRINI 365,14,RIO PRIMERO,218,RIO PRIMERO,4,6269,6272,1328
ESC.JORGE NEWBERY,PUBLICA,14,RIO PRIMERO,219,SAGRADA FAMILIA,1,6273,6273,181
INST DEL SANTISIMO ROSARIO,SAN MARTIN 756,14,RIO PRIMERO,220,VILLA SANTA ROSA,7,6274,6280,2317
ESC PBRO JOSE G BROCHERO,SANTA ROSA,14,RIO PRIMERO,220,VILLA SANTA ROSA,7,6281,6287,2310
INSTITUTO EL SALVADOR,SANTA ROSA,14,RIO PRIMERO,220,VILLA SANTA ROSA,8,6288,6295,2640
ESC PROV R SAENZ PEÑA,EL ALCALDE,14,RIO PRIMERO,221,EL ALCALDE,1,6296,6296,116
IPEM N°228-SAN ISIDRO LABRADOR,AV PEDRO J FONTANA 448,14,RIO PRIMERO,222,VILLA FONTANA,3,6297,6299,911
ESC.PROV.C.SAAVEDRA,PUBLICA,15,RIO SECO,223,CANDELARIA NORTE,3,6300,6302,764
ESC PROV PRIMERA JUNTA,ENCRUCIJADA,15,RIO SECO,224,ENCRUCIJADA,1,6303,6303,42
ESC GRAL SAN MARTIN,PUBLICA S/N,15,RIO SECO,225,GUTEMBERG,3,6304,6306,860
ESC PROV GENERAL PAZ,PUBLICA S/N,15,RIO SECO,225A,LA CAÑADA,1,6307,6307,89
ESC PRO MARTIN GUEMES,PUBLICA S/N,15,RIO SECO,226,LOS HOYOS,2,6308,6309,453
ESC.PROV.D.F.SARMIENTO,PUESTO DE CASTRO,15,RIO SECO,226A,PUESTO DE CASTRO,2,6310,6311,439
ESC.PROV.CNEL.F.DE BEDOYA,RAYO CORTADO,15,RIO SECO,227,RAYO CORTADO,3,6312,6314,700
ESC PROV GUILLERMO BROWN,PUBLICA S/N,15,RIO SECO,227A,RINCONADA,2,6315,6316,466
ESC PROV LUCIANO ARGUELLO,CERRO COLORADO,15,RIO SECO,227B,CERRO COLORADO,1,6317,6317,339
ESC PROV G MARTINEZ PIZARRO,PUBLICA S/N,15,RIO SECO,227C,CHAÑAR VIEJO,1,6318,6318,207
ESC PROV ING FEDERICO NEHHER,PUBLICA S/N,15,RIO SECO,227D,SANTA ELENA,2,6319,6320,346
ESC.PROV. CNEL. A.H.CARPANI,MAESTRO PIÑA 279,15,RIO SECO,228,SEBASTIAN ELCANO,8,6321,6328,2514
ESC JOSE DE SAN MARTIN,RIVADAVIA 768 CENTRO,15,RIO SECO,229,VILLA DE MARIA,7,6329,6335,2415
IPEM 224-LEOPOLDO LUGONES,RECONQUISTA,15,RIO SECO,229,VILLA DE MARIA,7,6336,6342,2408
ESC PROV LEOPOLDO LUGONES,SANTIAGO DEL ESTERO S/N,15,RIO SECO,229A,EUFRASIO LOZA,1,6343,6343,205
COLEGIO ENS.SECUNDARIA,CALCHIN,16,RIO SEGUNDO,230,CALCHIN,7,6344,6350,2150
ESC.PROV.M.BELGRANO,CALCHIN OESTE,16,RIO SEGUNDO,230A,CALCHIN OESTE,2,6351,6352,668
ESCUELA NARCISO LAPRIDA,GRAL JOSE DE SAN MARTIN S/N,16,RIO SEGUNDO,231,CAPILLA DEL CARMEN,2,6353,6354,364
ESC PROV PTE JULIO ROCA,MARIANO MORENO 815,16,RIO SEGUNDO,232,CARRILOBO,5,6355,6359,1705
ESC PROV SEMANA DE MAYO,ADALGISA 427,16,RIO SEGUNDO,233,COLAZO,4,6360,6363,1373
ESC LIB GRAL SAN MARTIN,PUBLICA S/N,16,RIO SEGUNDO,234,COSTA SACATE,4,6364,6367,1377
ESC BERNARDINO RIVADAVIA,RIVADAVIA 66 MALVINAS ARGENTINAS,16,RIO SEGUNDO,235,LAGUNA LARGA,8,6368,6375,2732
ESC NARCISO LAPRIDA,NARCISO LAPRIDA S/N,16,RIO SEGUNDO,235,LAGUNA LARGA,7,6376,6382,2387
INST GRAL JOSE MARIA PAZ,BV RIO CUARTO 599 CENTRO,16,RIO SEGUNDO,235,LAGUNA LARGA,5,6383,6387,1705
I.P.E.A.(IPEM231 TORAZO),LAS JUNTURAS,16,RIO SEGUNDO,236,LAS JUNTURAS,5,6388,6392,1545
ESC.PROV.D.F.SARMIENTO,PUBLICA,16,RIO SEGUNDO,236A,COLONIA VIDELA,1,6393,6393,45
IPEM N° 300,LUQUE,16,RIO SEGUNDO,237,LUQUE,7,6394,6400,2289
ESC GRAL JOSE DE SAN MARTIN,LUQUE,16,RIO SEGUNDO,237,LUQUE,10,6401,6410,3266
ESCUELA N°57,MANFREDI,16,RIO SEGUNDO,237A,MANFREDI,3,6411,6413,918
ESC PROV JERONIMO L DE CABRERA,PUBLICA S/N-IMPIRA,16,RIO SEGUNDO,237B,PUEBLO LUDUEÑA,1,6414,6414,189
ESC.PROV.D.F.SARMIENTO,CORRIENTES 237,16,RIO SEGUNDO,238,MATORRALES,3,6415,6417,956
ESC JOSE MARIA PAZ,ONCATIVO,16,RIO SEGUNDO,239,ONCATIVO,12,6418,6429,4110
ESC DE COM L LUGONES(IPEM 158),ONCATIVO,16,RIO SEGUNDO,239,ONCATIVO,7,6430,6436,2394
ESC EMILIO F OLMOS,ONCATIVO,16,RIO SEGUNDO,239,ONCATIVO,7,6437,6443,2394
IPEM N°54 J E MULLER,25 DE MAYO S/N,16,RIO SEGUNDO,239,ONCATIVO,9,6444,6452,3078
ESC ZENON LOPEZ,PILAR,16,RIO SEGUNDO,240,PILAR,14,6453,6466,4713
ESC JUAN BAUTISTA BUSTOS,PILAR,16,RIO SEGUNDO,240,PILAR,6,6467,6472,2016
ESC MARIA J GONZALEZ CASEROS,PILAR,16,RIO SEGUNDO,240,PILAR,11,6473,6483,3696
INST CARLOS PELLEGRINI,PILAR,16,RIO SEGUNDO,240,PILAR,6,6484,6489,2016
ESC GENERAL SAN MARTIN,POZO DEL MOLLE,16,RIO SEGUNDO,241,POZO DEL MOLLE,11,6490,6500,3610
ESC FRANCISCO MALBRAN,POZO DEL MOLLE,16,RIO SEGUNDO,241,POZO DEL MOLLE,6,6501,6506,1968
ESC PROV NICOLAS AVELLANEDA,RINCON,16,RIO SEGUNDO,242,RINCON,2,6507,6508,446
ESC MARIANO MORENO,CAÑADA DE MACHADO SUD,16,RIO SEGUNDO,242A,CAÑADA DE MACHADO SUD,1,6509,6509,17
C.E.N.M.A. N° 161,SAN MARTIN ESQ ALEM,16,RIO SEGUNDO,243,RIO SEGUNDO,6,6510,6515,2046
IPEM N°108-C G DE REZZANO,RIO SEGUNDO,16,RIO SEGUNDO,243,RIO SEGUNDO,11,6516,6526,3751
ESC PRIMER GOBIERNO PATRIO,RIVADAVIA 915,16,RIO SEGUNDO,243,RIO SEGUNDO,13,6527,6539,4423
ESC VICTOR MERCANTE,MARCONI 591 BELGRANO,16,RIO SEGUNDO,243,RIO SEGUNDO,12,6540,6551,4080
ESC CONGRESO DE TUCUMAN,RIO SEGUNDO,16,RIO SEGUNDO,243,RIO SEGUNDO,10,6552,6561,3400
ESC CORONEL PRINGLES,SANTIAGO TEMPLE,16,RIO SEGUNDO,244,SANTIAGO TEMPLE,8,6562,6569,2425
ESC PROV ESTANISLAO DEL CAMPO,PUBLICA S/N,16,RIO SEGUNDO,244A,LOS CHAÑARITOS,1,6570,6570,278
ESCUELA RECONQUISTA,VILLA DEL ROSARIO,16,RIO SEGUNDO,245,VILLA DEL ROSARIO,10,6571,6580,3429
ESC MARQUES DE SOBREMONTE,VILLA DEL ROSARIO,16,RIO SEGUNDO,245,VILLA DEL ROSARIO,13,6581,6593,4446
COLEGIO SAN JOSE,VILLA DEL ROSARIO,16,RIO SEGUNDO,245,VILLA DEL ROSARIO,15,6594,6608,5130
I.P.E.M. 278-M.ARGENTINAS,AV INDEPENDENCIA(B°CENTRO) 475,17,ROQUE SAENZ PEÑA,248,LABOULAYE,9,6609,6617,3069
ESC GRAL CONRADO VILLEGAS,INTENDENTE FENOGLIO(B° SANTA RITA) 344,17,ROQUE SAENZ PEÑA,248,LABOULAYE,10,6618,6627,3410
ESC LEONOR DE TEJEDA,AV PELLEGRINI(B°LA CHACARITA) 247,17,ROQUE SAENZ PEÑA,248,LABOULAYE,6,6628,6633,2046
COLEGIO SAN JOSE,RIVADAVIA(B°CENTRO) 245,17,ROQUE SAENZ PEÑA,248,LABOULAYE,8,6634,6641,2728
IPEM 257 DR RENE FAVALORO,AV INDEPENDENCIA(B°TERMINAL) 512,17,ROQUE SAENZ PEÑA,248,LABOULAYE,10,6642,6651,3405
ESC JUAN PASCUAL PRINGLES,AV INDEPENDENCIA(B°SUR) 284,17,ROQUE SAENZ PEÑA,248,LABOULAYE,10,6652,6661,3400
ESC VICTORIANO RODRIGUEZ,ALVEAR 220,17,ROQUE SAENZ PEÑA,249,LA CESIRA,5,6662,6666,1399
ESC N°78-PINTOR JUAN M BLANES,LEGUIZAMON,17,ROQUE SAENZ PEÑA,251,LEGUIZAMON,1,6667,6667,120
ESC GRAL NICOLAS LEVALLE,BERNARDINO ANCE(B°NORTE) 601,17,ROQUE SAENZ PEÑA,252,LEVALLE,7,6668,6674,2366
ESC DR VIRGILIO BARBALATO,CARLOS PELLEGRINI(B°SUR) 331,17,ROQUE SAENZ PEÑA,252,LEVALLE,8,6675,6682,2700
ESC.PROV.L.PASTEUR,PUBLICA,17,ROQUE SAENZ PEÑA,253,MELO,4,6683,6686,1147
ESC RAUL SOULE(EX NAC N°241),RIO BAMBA,17,ROQUE SAENZ PEÑA,254,RIO BAMBA,1,6687,6687,99
ESC.PROV.P.B.PALACIOS,CORRIENTES,17,ROQUE SAENZ PEÑA,255,ROSALES,2,6688,6689,540
ESC.PROV.GRAL SAN MARTIN,SAN JOAQUIN,17,ROQUE SAENZ PEÑA,256,SAN JOAQUIN,1,6690,6690,146
INS SAN ALBERTO Y SAN ENRIQUE,SERRANO,17,ROQUE SAENZ PEÑA,257,SERRANO,9,6691,6699,3034
ESCUELA N°105(JOSE RUBIROLA),VILLA ROSSI,17,ROQUE SAENZ PEÑA,258,VILLA ROSSI,2,6700,6701,568
ESC.PROV.M.DE AZCUENAGA,PUBLICA,18,SAN ALBERTO,259,ALTAUTINA,1,6702,6702,21
ESC.PROV.FRAY J.M.NOGAL,DOMINGO F SARMIENTO,18,SAN ALBERTO,260,AMBUL,3,6703,6705,944
ESC PROV JUAN P PRINGLES,PUBLICA S/N,18,SAN ALBERTO,260A,EL VOLCAN,1,6706,6706,35
IPEM N° 344,BROCHERO,18,SAN ALBERTO,261,BROCHERO,7,6707,6713,2330
ESC JOSE GABRIEL BROCHERO,MARIANO MORENO(B°CENTRO) 291,18,SAN ALBERTO,261,BROCHERO,6,6714,6719,1992
INST TRANSITO DE MARIA,IRINEO ALTAMIRANO(B°CENTRO) 60,18,SAN ALBERTO,261,BROCHERO,4,6720,6723,1328
ESC PROV JUAN MARTIN RECALDE,PUBLICA S/N,18,SAN ALBERTO,261A,SAN LORENZO,3,6724,6726,961
ESC.PROV.GUIDO SPANO,PUBLICA,18,SAN ALBERTO,261B,VILLA BENEGAS,1,6727,6727,48
ESC GRAL JOSE DE SAN MARTIN,MINA CLAVERO,18,SAN ALBERTO,262,MINA CLAVERO,11,6728,6738,3784
ESC MAESTRO D F SARMIENTO,AV HERNAN CORTEZ(B°MAYTHE) 1.060,18,SAN ALBERTO,262,MINA CLAVERO,6,6739,6744,2064
IPEM N° 285-J G BROCHERO,LOS FUNDADORES S/N (B°SANTA ANA),18,SAN ALBERTO,262,MINA CLAVERO,7,6745,6751,2404
ESC.PROV.D.F.SARMIENTO,SARMIENTO 223,18,SAN ALBERTO,263,NONO,7,6752,6758,2381
ESCUELA 20 DE JUNIO,PUBLICA S/N,18,SAN ALBERTO,263A,PAMPA DE ACHALA,1,6759,6759,122
ESC PROV CEFERINO NAMUNCURA,PUBLICA S/N,18,SAN ALBERTO,263B,LOS CERROS,1,6760,6760,20
ESC J V LOPEZ(EX-NAC N°493),RUTA N°14 Y ESMERALDA,18,SAN ALBERTO,263C,ARROYO DE LOS PATOS,2,6761,6762,610
ESC.PROV.M.A DE CARRANZA PREGO,LAS CALLES,18,SAN ALBERTO,263D,LAS CALLES,2,6763,6764,506
ESC.PROV.M.BELGRANO,RUTA NAC 14,18,SAN ALBERTO,263E,LAS RABONAS,3,6765,6767,717
ESC.P.PIZZURNO,PUBLICA,18,SAN ALBERTO,264,PANAHOLMA,2,6768,6769,396
ESC TOMAS DE IRIARTE,LOS ESPINILLOS,18,SAN ALBERTO,264A,LOS ESPINILLOS,1,6770,6770,223
ESC CNEL OLMEDO,CECILIA FUNES(B°CENTRO) 140,18,SAN ALBERTO,265,SAN PEDRO,13,6771,6783,4175
ESC CNEL AGUSTIN A OLMEDO,LIBERTAD (B°CENTRO) 270,18,SAN ALBERTO,265A,VILLA SARMIENTO,13,6784,6796,4457
ESC PROV MARIO REMORINO,PUBLICA S/N,18,SAN ALBERTO,265B,LA CORTADERA,1,6797,6797,82
ESC.PROV.FRAY L.BELTRAN,PUBLICA,18,SAN ALBERTO,265C,SAUCE ARRIBA,3,6798,6800,797
ESC MAESTRO H GALABURRI,PUBLICA S/N,18,SAN ALBERTO,266,SAN VICENTE,5,6801,6805,1404
ESC MARCELO T DE ALVEAR,SAN RAFAEL,18,SAN ALBERTO,266A,SAN RAFAEL,1,6806,6806,158
ESC PROV NARCISO LAPRIDA,PUBLICA S/N,19,SAN JAVIER,267,CONLARA,2,6807,6808,401
ESC MARIANO MORENO,PRESIDENTE PERON (B°JARDIN) 565,19,SAN JAVIER,268,DOLORES,10,6809,6818,3450
INST PBRO J V BRIZUELA,SARMIENTO (B°CENTRO) 270,19,SAN JAVIER,268,DOLORES,9,6819,6827,3105
ESC.NORMAL SARSFIELD,AV.S.MARTIN 271,19,SAN JAVIER,268,DOLORES,15,6828,6842,5175
ESC GENERAL SAN MARTIN,EDISON 130,19,SAN JAVIER,268,DOLORES,14,6843,6856,4830
ESC MANUEL BELGRANO,AV BELGRANO (B°FATIMA) 1.399,19,SAN JAVIER,268,DOLORES,7,6857,6863,2415
COLEGIO SAGRADO CORAZON,HORMAECHE (B°JARDIN) 375,19,SAN JAVIER,268,DOLORES,9,6864,6872,3097
ESC C CENTENARIO-IPEM N° 146,PEDRO C MOLINA 145,19,SAN JAVIER,268,DOLORES,8,6873,6880,2752
ESC DOLORES AGUIRRE DE FUNES,PEDRO C MOLINA S/N(B°TRADICION,19,SAN JAVIER,268,DOLORES,7,6881,6887,2408
INST JUAN BAUTISTA ALBERDI,LA PAZ,19,SAN JAVIER,269,LA PAZ,4,6888,6891,1268
ESC PROV JOSE M PAZ,VELEZ SARSFIELD Y BRAULIO FUNES,19,SAN JAVIER,269,LA PAZ,5,6892,6896,1584
ESC.PROV.J.M.ESTRADA,PUBLICA,19,SAN JAVIER,269A,QUEBRACHO LADEADO,1,6897,6897,254
ESC PROV JUAN JOSE PASO,RUTA NACIONAL 148 S/N,19,SAN JAVIER,269B,EL MANANTIAL,1,6898,6898,29
ESC MAGDALENA T DE CHARLES,PUBLICA S/N,19,SAN JAVIER,270,LAS ROSAS,9,6899,6907,3024
INST. VILLA DE LAS ROSAS,AV BELGRANO 350,19,SAN JAVIER,270,LAS ROSAS,4,6908,6911,1340
ESC LEOPOLDO LUG0NES,LAS TAPIAS,19,SAN JAVIER,271,LAS TAPIAS,5,6912,6916,1523
ESC JOSE DE SAN MARTIN,GRAL SAN MARTIN S/N,19,SAN JAVIER,272,LOS HORNILLOS,4,6917,6920,1169
ESC.PROV.EMILIO F.OLMOS,PUBLICA,19,SAN JAVIER,273,LUYABA,4,6921,6924,1208
ESC GENERAL SAN MARTIN,SAN JAVIER,19,SAN JAVIER,274,SAN JAVIER,3,6925,6927,724
ESCUELA PROVINCIAL,PUBLICA S/N,19,SAN JAVIER,274A,LA POBLACION,2,6928,6929,459
ESC EMILIO FELIPE OLMOS,AV SAN MARTIN S/N,19,SAN JAVIER,275,SAN JOSE,7,6930,6936,2119
ESC GENERAL BARTOLOME MITRE,LOS CERRILLOS,19,SAN JAVIER,275A,LOS CERRILLOS,6,6937,6942,2021
ESC GENERAL SAN MARTIN,PUBLICA,19,SAN JAVIER,276,YACANTO,4,6943,6946,1177
ESC JOSE MANUEL ESTRADA,ALICIA,20,SAN JUSTO,277,ALICIA,4,6947,6950,1340
ESC FRAY CAYETANO RODRIGUEZ,ALICIA,20,SAN JUSTO,277,ALICIA,5,6951,6955,1675
ESC.PROV.RECONQUISTA,SARMIENTO 543,20,SAN JUSTO,278,ALTOS DE CHIPION,6,6956,6961,1853
ESC MANUEL BELGRANO,RIVADAVIA (B°CENTRO) 473,20,SAN JUSTO,279,ARROYITO,11,6962,6972,3740
ESC JOSE MARIA PAZ,RIVADAVIA (B°CENTRO) 473,20,SAN JUSTO,279,ARROYITO,9,6973,6981,3051
INST DR D VELEZ SARSFIELD,ARROYITO,20,SAN JUSTO,279,ARROYITO,15,6982,6996,5085
ESCUELA N°198(ESC GIMENEZ LAGO,ARROYITO,20,SAN JUSTO,279,ARROYITO,14,6997,7010,4746
CERVELLON/NTRA S DE LA MERCED,9 DE JULIO (B°CENTRO) 465,20,SAN JUSTO,279,ARROYITO,9,7011,7019,3051
ESC PROV ALTE GUILLERMO BROWN,ALICIA ROSSI 441,20,SAN JUSTO,279A,EL FUERTECITO,2,7020,7021,373
ESC VICENTE LOPEZ Y PLANES,25 DE MAYO (B°IPV NORTE) 271,20,SAN JUSTO,280,BALNEARIA,6,7022,7027,1986
ESC PABLO JULIO RODRIGUEZ,GENERAL LAVALLE (B°IPV NORTE) 150,20,SAN JUSTO,280,BALNEARIA,7,7028,7034,2312
INST JUAN BAUTISTA ALBERDI,BALNEARIA,20,SAN JUSTO,280,BALNEARIA,4,7035,7038,1320
ESCUELA N°349(ESC JUAN BEIRO),BEIRO,20,SAN JUSTO,281,BEIRO,1,7039,7039,155
COLEGIO MANUEL BELGRANO,AV SEEBER (B°MANUEL BELGRANO) 317,20,SAN JUSTO,282,BRINKMANN,7,7040,7046,2380
ESC 25 DE MAYO,25 DE MAYO 975(B°25 DE MAYO),20,SAN JUSTO,282,BRINKMANN,10,7047,7056,3390
IPETIN 262 BELISARIO ROLDAN,DR PITT FUNES B°BERTOSSI 547,20,SAN JUSTO,282,BRINKMANN,8,7057,7064,2712
ESC.PROV.M.MORENO,TUCUMAN 483,20,SAN JUSTO,283,CONCEPCION,6,7065,7070,1767
ESC CONGRESO DE TUCUMAN,COLONIA PICHANAS,20,SAN JUSTO,283A,COLONIA PICHANAS,1,7071,7071,170
ESC CARLOS J FLORIT,DEVOTO,20,SAN JUSTO,285,DEVOTO,10,7072,7081,3445
ESC DOMINGO F SARMIENTO,DEVOTO,20,SAN JUSTO,285,DEVOTO,6,7082,7087,2064
ESC PROV DOMINGO F SARMIENTO,PUBLICA S/N,20,SAN JUSTO,286,DIEZ DE JULIO,1,7088,7088,151
ESC PROV L DE LA TORRE,PUBLICA S/N,20,SAN JUSTO,287,DOS HERMANOS,1,7089,7089,125
ESC PROV CHACABUCO,25 DE MAYO 381,20,SAN JUSTO,288,EL ARAÑADO,6,7090,7095,1965
ESCUELA PROV. ANTONIO SOBRAL,PUBLICA,20,SAN JUSTO,288A,VILLA SAN ESTEBAN,1,7096,7096,189
ESC PROV DOMINGO F SARMIENTO,MATEO OLIVERO 576,20,SAN JUSTO,289,EL FORTIN,4,7097,7100,1212
ESC PROV JOSE MARIA PAZ,15 DE OCTUBRE 588,20,SAN JUSTO,290,EL TIO,3,7101,7103,926
IPEM N°166 CAP G DEL VALLE,EL TIO,20,SAN JUSTO,290,EL TIO,3,7104,7106,924
COL STA TERESITA DEL N JESUS,BV 12 DE OCTUBRE 681,20,SAN JUSTO,291,FREYRE,8,7107,7114,2736
ESC FLORENTINO AMEGHINO,FREYRE,20,SAN JUSTO,291,FREYRE,10,7115,7124,3416
ESC PROV RAMON J CARCANO,PUBLICA S/N,20,SAN JUSTO,291A,COLONIA ANITA,1,7125,7125,79
ESC THOMAS ALVA EDISON,ITURRASPE,20,SAN JUSTO,292,ITURRASPE,1,7126,7126,112
INST COM SEC LA FRANCIA,LA FRANCIA,20,SAN JUSTO,293,LA FRANCIA,5,7127,7131,1605
ESC PROV DAMAS PATRICIAS,LA FRANCIA,20,SAN JUSTO,293,LA FRANCIA,6,7132,7137,1925
ESC PROV MARIANO MORENO,ALTE BROWN 231,20,SAN JUSTO,294,LA PAQUITA,3,7138,7140,987
ESC PROV NICOLAS AVELLANEDA,SARMIENTO S/N,20,SAN JUSTO,294A,COLONIA VALTELINA,1,7141,7141,182
ESC MARGARITA LA TORRE MERCADO,8 DE SEPTIEMBRE 107,20,SAN JUSTO,295,LA TORDILLA,5,7142,7146,1566
ESC.PROV.J.M.ESTRADA,PUBLICA,20,SAN JUSTO,295A,TORO PUJIO,1,7147,7147,252
IPEM N°287-L LUGONES,LASPIUR,20,SAN JUSTO,296,LASPIUR,7,7148,7154,2376
ESC PROV MARIANO MORENO,LAS VARAS,20,SAN JUSTO,297,LAS VARAS,4,7155,7158,1177
ESC NORM SUP D VELEZ SARSFIELD,ESCRIBANO LUIS MORELLI 188,20,SAN JUSTO,298,LAS VARILLAS,18,7159,7176,6156
ESCUELA GRAL PAZ,BUENOS AIRES 460,20,SAN JUSTO,298,LAS VARILLAS,6,7177,7182,2052
ESC BERNARDINO RIVADAVIA,INDEPENDENCIA 294,20,SAN JUSTO,298,LAS VARILLAS,8,7183,7190,2728
ESC BARTOLOME MITRE,SGTO CABRAL 521,20,SAN JUSTO,298,LAS VARILLAS,11,7191,7201,3751
ESC CONSTANCIO LUXARDO,PUBLICA S/N,20,SAN JUSTO,299,LUXARDO,2,7202,7203,358
INST SEC MANUEL DORREGO,SARMIENTO 295,20,SAN JUSTO,300,MARINA,4,7204,7207,1208
ESC.REP DEL PARAGUAY,BELGRANO 234,20,SAN JUSTO,301,MARULL,6,7208,7213,1757
ESC PROV GRAL SAN MARTIN,PUBLICA S/N,20,SAN JUSTO,302,MAUNIER,1,7214,7214,113
ESC.PROV.J.L.DE CABRERA,JERONIMO LUIS DE CABRERA,20,SAN JUSTO,303,MIRAMAR,7,7215,7221,2081
COLEGIO NACIONAL MIXTO,MORTEROS,20,SAN JUSTO,304,MORTEROS,14,7222,7235,4821
ESC D VELEZ SARSFIELD,EMILIO F OLMOS 375,20,SAN JUSTO,304,MORTEROS,11,7236,7246,3784
ESCUELA CRISTO REY,BV 9 DE JULIO 1.008,20,SAN JUSTO,304,MORTEROS,16,7247,7262,5504
ESC BERNARDINO RIVADAVIA,SARMIENTO 208,20,SAN JUSTO,304,MORTEROS,5,7263,7267,1720
INST BERNARDINO RIVADAVIA,PORTEÑA,20,SAN JUSTO,305,PORTEÑA,8,7268,7275,2650
ESC PROV 9 DE JULIO,PORTEÑA,20,SAN JUSTO,305,PORTEÑA,7,7276,7282,2317
ESC PROV SANTIAGO DERQUI,JUAREZ CELMAN 357,20,SAN JUSTO,306,PROSPERIDAD,2,7283,7284,553
ESC.PROV.AYACUCHO,SARMIENTO,20,SAN JUSTO,307,QUEBRACHO HERRADO,2,7285,7286,653
INST MANUEL BELGRANO,BELGRANO 960,20,SAN JUSTO,308,SACANTA,4,7287,7290,1308
ESCUELA ITUZAINGO,ITUZAINGO 251,20,SAN JUSTO,308,SACANTA,5,7291,7295,1632
ESC PROV PRIMERA JUNTA,9 DE JULIO 576,20,SAN JUSTO,309,SAN BARTOLOME,5,7296,7300,1549
ESC N AVELLANEDA(IPEM N°50),RIVADAVIA 679,20,SAN JUSTO,310,SAN FRANCISCO SECC. SUR,13,7301,7313,4459
ESC GENERAL MITRE,SANTA FE 538,20,SAN JUSTO,310,SAN FRANCISCO SECC. SUR,10,7314,7323,3430
COL SUP SAN MARTIN,PJE CHAMPAGNAT (SUR) 57,20,SAN JUSTO,310,SAN FRANCISCO SECC. SUR,13,7324,7336,4459
ESCUELA 2 DE ABRIL,FALUCHO Y PEATONAL LARREA N S/N,20,SAN JUSTO,310,SAN FRANCISCO SECC. SUR,10,7337,7346,3430
ESCUELA RIO NEGRO,CASEROS(B°LA CONSOLATA) 518,20,SAN JUSTO,310,SAN FRANCISCO SECC. SUR,11,7347,7357,3773
ESCUELA N AVELLANEDA,RIVADAVIA 648,20,SAN JUSTO,310,SAN FRANCISCO SECC. SUR,16,7358,7373,5476
ESCUELA RAFAEL NUÑEZ,PARAGUAY(B°CATEDRAL) 1.776,20,SAN JUSTO,310,SAN FRANCISCO SECC. SUR,8,7374,7381,2736
ESC JOSE BERRNARDO ITURRASPE,CABRERA(B°GENERAL ROCA) 1.736,20,SAN JUSTO,310A,SAN FRANCISCO SECC. NORTE,16,7382,7397,5494
ESC DOMINGO F SARMIENTO,ALMAFUERTE (B°ROCA) 104,20,SAN JUSTO,310A,SAN FRANCISCO SECC. NORTE,10,7398,7407,3430
COL SAN FCO DE ASIS,JUAN JOSE PASO (B°VELEZ SARSFIELD) 1.650,20,SAN JUSTO,310A,SAN FRANCISCO SECC. NORTE,9,7408,7416,3087
COLEGIO SAGRADO CORAZON,25 DE MAYO(B°ITURRASPE) 1.414,20,SAN JUSTO,310A,SAN FRANCISCO SECC. NORTE,6,7417,7422,2058
ESCUELA PRIMERA JUNTA,ENTRE RIOS(B°GENERAL ROCA) 2.505,20,SAN JUSTO,310A,SAN FRANCISCO SECC. NORTE,11,7423,7433,3773
ESC PTE HIPOLITO IRIGOYEN,JUJUY(B°ITURRASPE) 205,20,SAN JUSTO,310A,SAN FRANCISCO SECC. NORTE,13,7434,7446,4459
ESC JOSE MARIA PAZ,REPUBLICA DEL LIBANO 1.009,20,SAN JUSTO,310A,SAN FRANCISCO SECC. NORTE,12,7447,7458,4116
INST PASCUAL BAILON SOSA,AV TRIGUEROS(B°INDEPENDENCIA) 151,20,SAN JUSTO,310A,SAN FRANCISCO SECC. NORTE,2,7459,7460,686
ESC PROV 9 DE JULIO,COLONIA SAN PEDRO,20,SAN JUSTO,311,SAN PEDRO,1,7461,7461,264
ESC.PROV.J.DE SAN MARTIN,SAUZE,20,SAN JUSTO,312,SAUZE,1,7462,7462,22
ESCUELA N°149(HOY:JOSE SEEBER),SEEBER,20,SAN JUSTO,313,SEEBER,2,7463,7464,659
ESC PROV R GUTIERREZ,TRANSITO,20,SAN JUSTO,314,TRANSITO,9,7465,7473,3044
COL MARIA AUXILIADORA,ANA PASSADORE 611,20,SAN JUSTO,315,VIGNAUD,2,7474,7475,645
ESC COMANDANTE ESPORA,3 DE FEBRERO(B° SUR) 362,21,SANTA MARIA,316,ALTA GRACIA,12,7476,7487,4128
ESC VICTOR MERCANTE,ANATOLE FRANCE(B°CARLOS PELLEGRINI) 360,21,SANTA MARIA,316,ALTA GRACIA,8,7488,7495,2752
INST EL OBRAJE (ARRIBA),NIETO(B°POLUYAN) 17,21,SANTA MARIA,316,ALTA GRACIA,6,7496,7501,2059
INST DE LA MISERICORDIA,PADRE DOMINGO VIERA 151,21,SANTA MARIA,316,ALTA GRACIA,10,7502,7511,3430
INST SUP ANGLO AMERICANO,BV CARLOS PELLEGRINI 637,21,SANTA MARIA,316,ALTA GRACIA,7,7512,7518,2401
ESC NAC NORM SUP ALTA GRACIA,JOSE HERNANDEZ(B°CAMARA) 201,21,SANTA MARIA,316,ALTA GRACIA,10,7519,7528,3430
ESCUELA SAN MARTIN,URUGUAY(B°NORTE) 200,21,SANTA MARIA,316,ALTA GRACIA,9,7529,7537,3087
ESC REPUBLICA ITALIANA,COLEGIO 127 LALAHENES,21,SANTA MARIA,316,ALTA GRACIA,8,7538,7545,2744
I.P.E.M. N° 298,RAFAEL LOZADA(B°CENTRO) 53,21,SANTA MARIA,316,ALTA GRACIA,14,7546,7559,4802
ESCUELA CURA ELEODORO FIERRO,RAMON J CARCANO(B°GOB A SABATTINI) 135,21,SANTA MARIA,316,ALTA GRACIA,13,7560,7572,4459
ESCUELA JOSE MARIA PAZ,LOS ANDES(B°CAMARA) 80,21,SANTA MARIA,316,ALTA GRACIA,9,7573,7581,3087
ESCUELA MANUEL SOLARES,ESPAÑA (B°SUR) 26,21,SANTA MARIA,316,ALTA GRACIA,8,7582,7589,2744
ESC SANTIAGO DE LINIERS,B°LINIERS,21,SANTA MARIA,316,ALTA GRACIA,8,7590,7597,2744
IPEM N° 118-JUANA AZURDUY,SALOMON PALACIOS,21,SANTA MARIA,316A,ANIZACATE,6,7598,7603,2022
ESC VICENTE LOPEZ Y PLANES,ANIZACATE,21,SANTA MARIA,316A,ANIZACATE,6,7604,7609,2021
ESC PROV DOMINGO F SARMIENTO,PUBLICA S/N,21,SANTA MARIA,316B,LA PAISANITA,1,7610,7610,165
LOCAL COMUNAL,LA RANCHERITA,21,SANTA MARIA,316C,LA RANCHERITA,1,7611,7611,159
ESC GENERAL MANUEL BELGRANO,LA SERRANITA,21,SANTA MARIA,316D,LA SERRANITA,2,7612,7613,427
ESC PROV CATALINA E DE BARON,ANICETO GRANADO S/N,21,SANTA MARIA,316E,LOS CEDROS,4,7614,7617,1136
IPET N°118 AZURDUY (CIRC 316A),SALOMON PALACIOS S/N,21,SANTA MARIA,316F,VALLE DE ANIZACATE,3,7618,7620,793
ESC.PROV.J.HERNANDEZ,CALLE 10 ESQ AV N 5,21,SANTA MARIA,316G,VILLA EL PRADO,4,7621,7624,1365
LOCAL COMUNAL,VILLA LA BOLSA,21,SANTA MARIA,316H,VILLA LA BOLSA,3,7625,7627,974
ESC PROV DOMINGO F SARMIENTO,VILLA LOS AROMOS,21,SANTA MARIA,316I,VILLA LOS AROMOS,3,7628,7630,850
IPET 334,AV RIVADARIA S/N,21,SANTA MARIA,316J,VILLA PARQUE SANTA ANA,8,7631,7638,2572
ESC PROV B DE MONTEAGUDO,CALLE PUBLICA P/ANIZACATE,21,SANTA MARIA,317,BAJO CHICO,1,7639,7639,298
ESC.PROV.FRENCH Y BERUTTI,SARMIENTO Y BERUTTI(RAFAEL GARCIA),21,SANTA MARIA,318,RAFAEL GARCIA,2,7640,7641,648
ESC DR FLORENTINO F BUSTOS,LIBERTADOR SAN MARTIN,21,SANTA MARIA,319,BOUWER,5,7642,7646,1553
OLEGARIO V ANDRADE (CIRC 322),PUBLICA S/N -COSME NORTE,21,SANTA MARIA,320,BUENA VISTA,1,7647,7647,27
ESC PROV OLEGARIO V ANDRADE,PUBLICA S/N,21,SANTA MARIA,322,COSME,1,7648,7648,50
INSTITUTO PRIVADO PIO XII,PADRE BUTELER 229,21,SANTA MARIA,323,DESPEÑADEROS,10,7649,7658,3300
ESC PROV 25 DE MAYO,CONGRESO 235,21,SANTA MARIA,323,DESPEÑADEROS,7,7659,7665,2304
ESC PROV DOMINGO F SARMIENTO,PUBLICA S/N,21,SANTA MARIA,324,FALDA DEL CARMEN,4,7666,7669,1266
ESC.PROV.B.RIVADAVIA,SARMIENTO 441,21,SANTA MARIA,325,LOZADA,5,7670,7674,1414
ESC PROV MANUEL BELGRANO,GRAL BUSTOS 700,21,SANTA MARIA,326,MALAGUEÑO,12,7675,7686,3984
I.P.E.M.67-L.PIEDRABUENA,MALAGUEÑO,21,SANTA MARIA,326,MALAGUEÑO,9,7687,7695,2988
COLEGIO JUAN XXIII,BRIGADIER SAN MARTIN 231,21,SANTA MARIA,326A,YOCSINA,6,7696,7701,1976
ESC PROV GABRIELA MISTRAL,MARCELO GARLOT,21,SANTA MARIA,326A,YOCSINA,2,7702,7703,658
ESC PROV FRAY J S MARIA DE ORO,CRUCERO GENERAL BELGRANO S/N,21,SANTA MARIA,326B,BARRIO PRIMERO DE MAYO,4,7704,7707,1348
ESC MARTIN M DE GUEMES,A CASTELLANO,21,SANTA MARIA,326C,SAN NICOLAS,6,7708,7713,1744
ESC.DELL'ARMELLINA,ITALIA,21,SANTA MARIA,327,MONTE RALO,2,7714,7715,488
ESC IPEM 32-EST POT DE GARAY,LAS MONJITAS S/N,21,SANTA MARIA,328,POTRERO DE GARAY,4,7716,7719,1241
ESC.PROV.J.V.GONZALEZ,RUTA N 5 KM 54,21,SANTA MARIA,328B,VILLA CIUDAD DE AMERICA,3,7720,7722,744
ESC.PROV.J.B.CABRAL,PUBLICA,21,SANTA MARIA,329,SAN CLEMENTE,1,7723,7723,185
ESC.PROV.M.MORENO,PUBLICA,21,SANTA MARIA,330,SAN ISIDRO,2,7724,7725,623
ESCUELA DE MINERIA,JOSE DE LA QUINTANA,21,SANTA MARIA,330A,JOSE DE LA QUINTANA,2,7726,7727,514
ESC PROV JUAN B ALBERDI,TOLEDO,21,SANTA MARIA,331,TOLEDO,7,7728,7734,2317
IPEM 107 REINO DE ESPAÑA,TOLEDO,21,SANTA MARIA,331,TOLEDO,6,7735,7740,1982
ESC.PROV.FCO.PASCACIO MORENO,POZO NUEVO,22,SOBREMONTE,332,POZO NUEVO,2,7741,7742,561
ESC V LOPEZ Y PLANES,CAMINIAGA,22,SOBREMONTE,333,CAMINIAGA,2,7743,7744,453
ESC PROV MARIANO MORENO,PUBLICA S/N,22,SOBREMONTE,334,CHUÑAHUASI,1,7745,7745,344
I.P.E.T. N°17,CHAÑAR,22,SOBREMONTE,335,CHAÑAR,8,7746,7753,2548
COL NAC JOSE M ESTRADA,URUGUAY 55,23,TERCERO ARRIBA,336,ALMAFUERTE,13,7754,7766,4485
ESC REMEDIOS E DE SAN MARTIN,CASTELLI 590,23,TERCERO ARRIBA,336,ALMAFUERTE,11,7767,7777,3786
IPEM N° 299-DR S E NAUMCHIK,SANTIAGO DEL ESTERO ESQ.FRAGUEIRO,23,TERCERO ARRIBA,336,ALMAFUERTE,6,7778,7783,2064
ESC.M.G.PONCE,DUSSAN ALACEVICH 86,23,TERCERO ARRIBA,337,ASCASUBI,7,7784,7790,2264
ESC PROV JUAN B ALBERDI,SANTA ROSA 171,23,TERCERO ARRIBA,337A,CNIA ALMADA,2,7791,7792,565
ESC PROV GRAL J DE SAN MARTIN,PABLO A PIZZURNO 149,23,TERCERO ARRIBA,338,CORRALITO,5,7793,7797,1673
ESC PROV FRAY LUIS BELTRAN,JUANA AZURDUY 283,23,TERCERO ARRIBA,339,DALMACIO VELEZ,5,7798,7802,1407
ESC GOB J F JAVIER DIAZ,HERNANDO,23,TERCERO ARRIBA,340,HERNANDO,7,7803,7809,2387
COLEGIO DIVINO CORAZON,25 DE MAYO 100,23,TERCERO ARRIBA,340,HERNANDO,5,7810,7814,1705
ESC PABLO A PIZZURNO,HERNANDO,23,TERCERO ARRIBA,340,HERNANDO,9,7815,7823,3069
ESC LA STMA TRINIDAD,COLON 102,23,TERCERO ARRIBA,340,HERNANDO,8,7824,7831,2721
INST SEC JOSE M ESTRADA,JAMES CRAIK,23,TERCERO ARRIBA,341,JAMES CRAIK,6,7832,7837,1965
ESC PROV J M SALGUEIRO,JAMES CRAIK,23,TERCERO ARRIBA,341,JAMES CRAIK,8,7838,7845,2616
ESC PROV DOMINGO F SARMIENTO,LAS PERDICES,23,TERCERO ARRIBA,342,LAS PERDICES,6,7846,7851,1975
ESC CNEL DOMINGO GAY,SAN LUIS Y GENERAL PAZ S/N,23,TERCERO ARRIBA,342,LAS PERDICES,7,7852,7858,2303
ESC VICENTE LOPEZ Y PLANES,SAN MARTIN 346,23,TERCERO ARRIBA,343,LOS ZORROS,2,7859,7860,603
ESC PROV BARTOLOME MITRE,ALVEAR 320,23,TERCERO ARRIBA,344,OLIVA,7,7861,7867,2394
C0LEGIO SAGRADO CORAZON,DON BOSCO S/N,23,TERCERO ARRIBA,344,OLIVA,13,7868,7880,4437
ESCUELA NAC.DE COMERCIO,OLIVA,23,TERCERO ARRIBA,344,OLIVA,13,7881,7893,4433
ESC PROV ANTARTIDA ARGENTINA,PAMPAYASTA NORTE,23,TERCERO ARRIBA,345,PAMPAYASTA NORTE,2,7894,7895,425
ESC.PROV. REYES CATOLICOS,RIVADAVIA 198,23,TERCERO ARRIBA,346,PAMPAYASTA SUD,4,7896,7899,1271
ESC.PROV.S.A.GUTIERREZ,PUBLICA,23,TERCERO ARRIBA,347,PUNTA DEL AGUA,1,7900,7900,227
ESC PROV GABRIELA MISTRAL,LAS ISLETILLAS,23,TERCERO ARRIBA,347A,LAS ISLETILLAS,1,7901,7901,262
ESC PROV MODESTO ACUÑA,AMINTA R DE HERRERA 455,23,TERCERO ARRIBA,348,RIO TERCERO,12,7902,7913,4128
E.N.E.T. N°1,G.SAVIO Y MENDOZA,23,TERCERO ARRIBA,348,RIO TERCERO,15,7914,7928,5160
INST ALEXIS CARREL,GRAL PAZ Y ESPAÑA 390,23,TERCERO ARRIBA,348,RIO TERCERO,17,7929,7945,5848
ESC PROV R E DE SAN MARTIN,25 DE FEBRERO 171,23,TERCERO ARRIBA,348,RIO TERCERO,12,7946,7957,4128
ESC SUP DE COMERCIO,D DE ROJAS S/N-B°LAS VILETAS,23,TERCERO ARRIBA,348,RIO TERCERO,6,7958,7963,2064
COLEGIO JESUS MARIA Y JOSE,SAN AGUSTIN 318,23,TERCERO ARRIBA,348,RIO TERCERO,14,7964,7977,4816
ESC GREGORIA I PEREZ,ANGELINA ORTIZ ESQ INDEPENDENCIA S/N,23,TERCERO ARRIBA,348,RIO TERCERO,10,7978,7987,3440
ESC JOSE M ZAPIOLA,CHACABUCO 649,23,TERCERO ARRIBA,348,RIO TERCERO,13,7988,8000,4460
ESCUELA N° 402,I.LA CATOLICA 190,23,TERCERO ARRIBA,348,RIO TERCERO,13,8001,8013,4459
COLEGIO C SAAVEDRA LAMAS,HILARIO CUADROS Y EDMUNDO CARTOS S/N,23,TERCERO ARRIBA,348,RIO TERCERO,10,8014,8023,3430
ESC PROV JOSE M PAZ,BARTOLOME MITRE 451,23,TERCERO ARRIBA,349,TANCACHA,7,8024,8030,2410
ESC GRAL JOSE DE SAN MARTIN,SARMIENTO 1.076,23,TERCERO ARRIBA,349,TANCACHA,7,8031,8037,2408
ESC PROV GRAL BATOLOME MITRE,SAN JUAN ESQ BELGRANO,23,TERCERO ARRIBA,349A,GENERAL FOTHERINGHAM,2,8038,8039,352
ESC PROV GRAL ARENALES,CANDELARIA,24,TOTORAL,350,CANDELARIA,2,8040,8041,400
ESC.R.J.CARCANO,CAÑADA DE LUQUE,24,TOTORAL,351,CAÑADA DE LUQUE,4,8042,8045,1185
ESC PROV BERNARDINO RIVADAVIA,PUBLICA S/N,24,TOTORAL,351A,LA PAMPA,3,8046,8048,718
ESC.PROV.J.F.KENNEDY,LIDORO CENTURION 324,24,TOTORAL,352,LAS PEÑAS,5,8049,8053,1673
ESC PROV PEDRO N ARIAS,PUBLICA S/N,24,TOTORAL,352A,LOS MISTOLES,1,8054,8054,144
ESC CEFERINO NAMUNCURA,MACHA,24,TOTORAL,353,MACHA,1,8055,8055,76
ESC PROV GREGORIA MATORRAS,PUBLICA S/N,24,TOTORAL,354,SANTA CATALINA,1,8056,8056,234
ESC.PROV.S.MARTIN Y GOMEZ,PUBLICA,24,TOTORAL,355,SARMIENTO,4,8057,8060,1088
ESC.PROV.F.AMEGHINO,PUBLICA,24,TOTORAL,356,SIMBOLAR,1,8061,8061,319
ESC.PROV.CNEL. PRINGLES,PUBLICA- CAMINO A SAN LORENZO,24,TOTORAL,357,SINSACATE,6,8062,8067,1774
ESC.PROV.24 DE SEPTIEMBRE,8 DE DICIEMBRE S/N,24,TOTORAL,358,SITON,2,8068,8069,626
ESC PROV BARTOLOME MITRE,BV.ALLENDE S/N,24,TOTORAL,359,VILLA DEL TOTORAL,10,8070,8079,3375
ESC NORM SUP V DEL TOTORAL,REP ARGENTINA Y PTE PERON S/N,24,TOTORAL,359,VILLA DEL TOTORAL,6,8080,8085,2022
IPETYM N° 74 FRAY M ESQUIU,S/C S/N,24,TOTORAL,359,VILLA DEL TOTORAL,7,8086,8092,2359
ESC PROV MARIANO MORENO,PUBLICA S/N,25,TULUMBA,360,CHURQUI CAÑADA,1,8093,8093,163
ESC PROV MIGUEL DE GUEMES,EL RODEO,25,TULUMBA,360A,EL RODEO,1,8094,8094,243
ESCUELA ESTEBAN ECHEVERRIA,LA TOMA,25,TULUMBA,360B,LA TOMA,1,8095,8095,115
ESC.J.M.ESTRADA,AV.SAN MARTIN,25,TULUMBA,361,LAS ARRIAS,6,8096,8101,2046
ESC PROV 25 DE MAYO,EL BAÑADO,25,TULUMBA,362,EL BAÑADO,1,8102,8102,39
ESC PROV JOSE MARMOL,CAMINO PROVINCIAL S/N,25,TULUMBA,363,ISLA DE SAN ANTONIO,1,8103,8103,49
I.P.E.A. N°15,2A DORMIDA,25,TULUMBA,364,LA DORMIDA,7,8104,8110,2401
ESC.PROV.F.N.LAPRIDA,LA DORMIDA,25,TULUMBA,364,LA DORMIDA,6,8111,8116,2058
ESC LUIS E JUNCOS(EX NAC 212),LAS MASITAS,25,TULUMBA,365,LAS MASITAS,1,8117,8117,16
ESC.MARIA L.ROBLEDO,PUBLICA,25,TULUMBA,366,LUCIO V MANSILLA,4,8118,8121,1088
ESC.PROV.D.F.SARMIENTO,JAVIER GARCIA,25,TULUMBA,367,ROSARIO DEL SALADILLO,2,8122,8123,493
ESC.PROV.V.MERCANTE,ONCATIVO,25,TULUMBA,368,SAN JOSE DE LAS SALINAS,2,8124,8125,648
ESC MANUEL BELGRANO,9 DE JULIO S/N,25,TULUMBA,369,SAN PEDRO NORTE,2,8126,8127,587
ESC PROV CORNELIO SAAVEDRA,PUBLICA S/N,25,TULUMBA,370,SANTA CRUZ,1,8128,8128,97
ESC PROV MANUEL DORREGO,PUBLICA S/N,25,TULUMBA,370A,LA CAÑADA,1,8129,8129,28
ESC.PROV.OB.O.CORREA,CALLE REAL,25,TULUMBA,371,TULUMBA,6,8130,8135,1844
ESC.PROV.DR.GARCIA GONZALEZ,JULIO A ROCA 115,26,UNION,372,ALTO ALEGRE,4,8136,8139,1122
ESC PROV JUAN P ESNAOLA,ANA ZUMARAN,26,UNION,372A,ANA ZUMARAN,1,8140,8140,175
ESC PROV GRAL SAN MARTIN,PTE PERON- CENTRO 75,26,UNION,373,BALLESTEROS,7,8141,8147,2338
ESC GRAL BELGRANO-IPEM N°139,ANSELMO G VAZQUEZ-CENTRO 522,26,UNION,373,BALLESTEROS,4,8148,8151,1335
ESCUELA N°9,BALLESTEROS SUD,26,UNION,374,BALLESTEROS SUD,2,8152,8153,675
ESC.NORMAL F.ALCORTA,25 DE MAYO 135,26,UNION,375,BELL VILLE,22,8154,8175,7568
ESC F AMEGHINO,ENTRE RIOS 457,26,UNION,375,BELL VILLE,11,8176,8186,3784
ESC.SUPERIOR DE COMERCIO,F.MOLINA 69,26,UNION,375,BELL VILLE,14,8187,8200,4816
ESCUELA A MATTERSON,PTE PERON 414,26,UNION,375,BELL VILLE,12,8201,8212,4128
ESC PONCIANO VIVANCO,AMEGHINO 155,26,UNION,375,BELL VILLE,16,8213,8228,5489
COLEGIO SAN JOSE,BV FIGUEROA ALCORTA 40,26,UNION,375,BELL VILLE,14,8229,8242,4802
ESC PROV B ERNARDINO RIVADAVIA,RIVADAVIA 360,26,UNION,376,BISMARCK,2,8243,8244,415
ESC PROV ALMAFUERTE,PUBLICA S/N,26,UNION,377,BREMEN,1,8245,8245,246
ESC PROV J HERNANDEZ,CANALS,26,UNION,378,CANALS,10,8246,8255,3353
INSTITUTO BELISARIO ROLDAN,CANALS,26,UNION,378,CANALS,13,8256,8268,4355
ESC.PROV.A.M.ZUMARAN D CARCANO,PUBLICA,26,UNION,379,CARCANO,1,8269,8269,17
ESC DE COM JOSE M.ESTRADA,BELGRANO 548,26,UNION,381,CINTRA,4,8270,8273,1350
ESC PROV B QUINQUELA MARTIN,SANTA FE S/N,26,UNION,382,CHILIBROSTE,2,8274,8275,615
ESC.PROV.V.LOPEZ Y PLANES,BUENOS AIRES 414,26,UNION,384,PUEBLO ITALIANO,5,8276,8280,1585
ESC.M.C.G.DE MATOCCIA,ITALIA 1.320,26,UNION,385,ESCALANTE,4,8281,8284,1367
ESC R VERA PEÑALOZA,GOULD,26,UNION,386,GOULD,2,8285,8286,632
ESC P ALBARRACIN DE SARMIENTO,9 DE JULIO 551,26,UNION,387,IDIAZABAL,5,8287,8291,1470
ESCUELA MARIANO MORENO,LABORDE,26,UNION,389,LABORDE,5,8292,8296,1630
INST SUP DE PROFESORADO,SAN MARTIN 451,26,UNION,389,LABORDE,6,8297,8302,1955
ESCUELA PROV DARDO ROCHA,LABORDE,26,UNION,389,LABORDE,5,8303,8307,1625
ESC.PROV.D.F.SARMIENTO,CARDO 146,26,UNION,390,MONTE LEÑA,2,8308,8309,514
INSTITUTO SAGRADO CORAZON,9 DE JULIO 2.250,26,UNION,391,MONTE MAIZ,13,8310,8322,4290
ESCUELA JOSE DE SAN MARTIN,SAN MARTIN 1.518,26,UNION,391,MONTE MAIZ,7,8323,8329,2310
ESC PROV NIÑAS DE AYOHUMA,VICENTE LOPEZ Y PLANES S/N,26,UNION,392,MORRISON,4,8330,8333,1328
ESC PROV LEOPOLDO LUGONES,MORRISON,26,UNION,392,MORRISON,6,8334,8339,1989
ESC PROV R E DE SAN MARTIN,NOETINGER,26,UNION,393,NOETINGER,6,8340,8345,1956
ESCUELA LEANDRO N ALEM,NOETINGER,26,UNION,393,NOETINGER,8,8346,8353,2602
ESCUELA AMADEO AUCHTER,CALLE 10 N°119,26,UNION,394,ORDOÑEZ,7,8354,8360,2356
INST GALA ORTIZ FERNANDEZ,ESPAÑA 16,26,UNION,395,PASCANAS,5,8361,8365,1547
ESC MAESTRO J RECALDE,PASCANAS,26,UNION,395,PASCANAS,3,8366,8368,927
INST DALMACIO VELEZ SARSFIELD,BELGRANO 222,26,UNION,396,POSSE,12,8369,8380,4093
ESC PROV JUANA MANSO,DEAN FUNES 346,26,UNION,396,POSSE,5,8381,8385,1705
INSTITUTO SAN JOSE,9 DE JULIO Y COLON,26,UNION,396,POSSE,5,8386,8390,1705
ESC.PROV.M.SASTRE,PUBLICA,26,UNION,396A,VILLA LOS PATOS,1,8391,8391,43
ESC.PROV.P.PIZZURNO,MAESTRO FERNANDEZ 538,26,UNION,397,SAN ANTONIO,5,8392,8396,1446
ESCUELA VALENTIN ALSINA,CORRAL DEL BAJO,26,UNION,397A,CORRAL DEL BAJO,1,8397,8397,13
INST JOSE DE SAN MARTIN,SAN MARCOS SUD,26,UNION,400,SAN MARCOS SUD,4,8398,8401,1380
ESC PROV M BUCHARDO,SAN MARCOS SUD,26,UNION,400,SAN MARCOS SUD,4,8402,8405,1377
ESC PROV PAULA ALBARRACIN,PUBLICA S/N,26,UNION,401,SANTA MARIA,1,8406,8406,204
INSTITUTO JUAN B ALBERDI,AVELLANEDA 182,26,UNION,402,VIAMONTE,5,8407,8411,1574
